county,precinct,OMALLEY,SANDERS,CLINTON,FUENTE,UNCOMMITTED,TOTAL
21001,A102,0,10,3,0,1,14
21001,A104,2,18,4,0,1,25
21001,A105,1,9,9,0,0,19
21001,B102,1,33,38,0,3,75
21001,B104,0,25,15,0,2,42
21001,C102,4,28,31,0,2,65
21001,C104,0,32,36,0,0,68
21001,D101,0,14,8,0,4,26
21001,D103,0,25,20,0,1,46
21001,D104,1,16,51,0,1,69
21001,E101,1,15,16,0,4,36
21001,E104,1,37,58,0,4,100
21001,F101,1,48,58,0,6,113
21001,F103,2,19,24,1,3,49
21001,G101,0,34,45,1,3,83
21001,G102,3,34,34,0,6,77
21003,A101,0,27,39,0,5,71
21003,A102,1,45,22,3,3,74
21003,B101,2,35,38,0,4,79
21003,B102,0,29,14,0,4,47
21003,B103,1,26,18,0,2,47
21003,C101,0,43,58,0,1,102
21003,C102,0,49,42,1,2,94
21003,D101,1,40,36,0,7,84
21003,D102,0,28,27,1,5,61
21003,D103,0,37,51,0,9,97
21003,E101,0,15,13,0,3,31
21003,E102,0,31,30,1,3,65
21003,E103,0,19,14,0,1,34
21005,A101,4,104,103,2,9,222
21005,A102,2,102,56,2,17,179
21005,B101,2,110,96,0,15,223
21005,B102,14,176,101,2,34,327
21005,C101,6,95,121,2,32,256
21005,C102,6,122,78,0,14,220
21005,D101,4,95,48,1,10,158
21005,D102,8,156,97,1,18,280
21005,E101,8,213,158,6,46,431
21005,E103,9,97,81,0,18,205
21005,F101,1,90,49,1,11,152
21005,F102,2,82,28,2,7,121
21005,F103,3,47,25,1,5,81
21005,F104,4,122,50,0,20,196
21007,A101,3,51,20,0,9,83
21007,A102,6,87,78,0,32,203
21007,A103,2,27,8,0,12,49
21007,B101,1,69,59,0,19,148
21007,B102,5,22,12,0,9,48
21007,C101,2,39,23,0,8,72
21007,C102,1,42,23,0,7,73
21007,C103,3,30,22,0,8,63
21007,C104,5,38,19,0,6,68
21007,D101,2,97,57,0,21,177
21007,D102,1,45,21,0,11,78
21007,E101,1,80,29,0,16,126
21007,E102,1,27,21,0,10,59
21009,A101,10,118,136,3,29,296
21009,A102,0,60,110,1,7,178
21009,A103,2,112,73,1,21,209
21009,A104,0,32,20,0,8,60
21009,B101,5,151,95,3,29,283
21009,B102,3,104,85,1,24,217
21009,B103,7,66,28,0,10,111
21009,B104,7,120,80,0,18,225
21009,C101,1,68,47,0,16,132
21009,C102,4,98,59,0,18,179
21009,C103,1,69,69,2,18,159
21009,C104,4,124,59,0,16,203
21009,D101,1,107,63,2,32,205
21009,D102,3,178,104,1,48,334
21009,D103,8,117,130,0,33,288
21009,E101,5,114,74,2,14,209
21009,E102,1,73,50,0,14,138
21009,E103,4,109,69,1,31,214
21009,E104,5,113,56,1,34,209
21009,F101,6,97,66,1,14,184
21009,F102,3,95,62,1,19,180
21009,F103,4,136,108,1,39,288
21009,G101,3,124,86,1,25,239
21009,G102,0,90,66,0,11,167
21009,G103,6,119,102,1,25,253
21011,A101,3,40,33,0,3,79
21011,A102,1,32,46,0,4,83
21011,A103,1,47,31,1,2,82
21011,A104,0,28,22,1,1,52
21011,A105,2,79,70,0,8,159
21011,B102,1,44,63,1,6,115
21011,B103,2,108,97,1,11,219
21011,B104,0,55,32,2,8,97
21011,C101,3,54,57,1,8,123
21011,C102,0,74,58,0,12,144
21011,C103,0,38,52,1,7,98
21011,C104,1,23,42,0,8,74
21005,A102,1,19,17,0,4,41
21005,A103,2,28,28,0,1,59
21005,A104,2,42,54,0,5,103
21005,A105,0,20,33,0,1,54
21005,A106,0,38,30,0,1,69
21005,A107,0,10,12,0,1,23
21005,A108,1,49,44,1,1,96
21005,A109,0,69,45,1,4,119
21005,A110,1,37,23,0,4,65
21005,A111,2,49,63,0,1,115
21005,A112,0,33,20,0,3,56
21005,A113,0,39,59,0,7,105
21005,A114,2,40,62,0,4,108
21005,A115,0,55,53,0,1,109
21005,A116,0,26,36,0,0,62
21005,A117,0,49,55,0,3,107
21005,A118,1,27,33,0,2,63
21005,A119,0,19,21,0,1,41
21005,A120,3,34,53,0,4,94
21005,A121,0,54,62,0,1,117
21005,A122,0,31,31,0,4,66
21005,A123,0,49,23,0,1,73
21005,B114,1,31,28,0,5,65
21005,B115,1,25,23,0,3,52
21005,B116,0,27,36,1,0,64
21005,B117,1,58,64,2,1,126
21005,B118,0,24,42,0,1,67
21005,B119,0,23,45,0,0,68
21005,B120,1,32,41,0,1,75
21005,B121,0,69,66,2,2,139
21005,B122,3,35,42,1,3,84
21005,B123,1,63,70,0,4,138
21005,B124,1,51,70,0,1,123
21005,B125,1,46,73,0,1,121
21005,B126,0,33,34,0,4,71
21005,B127,1,43,48,0,4,96
21005,B128,0,38,39,0,3,80
21005,B129,0,41,44,0,2,87
21005,B130,1,54,92,0,3,150
21005,B131,1,52,74,0,3,130
21005,B132,1,48,54,0,1,104
21005,B133,1,35,61,0,5,102
21005,B134,0,33,50,0,1,84
21005,C102,0,52,45,0,2,99
21005,C110,0,42,58,0,1,101
21005,C117,0,35,56,0,3,94
21005,C121,0,59,62,1,1,123
21005,C123,2,21,31,0,3,57
21005,C124,3,42,61,0,7,113
21005,C125,0,25,30,0,2,57
21005,C126,0,15,14,0,0,29
21005,C127,1,41,34,0,1,77
21005,C128,0,26,25,0,3,54
21005,C129,2,37,25,0,4,68
21005,C130,3,53,84,1,5,146
21005,C131,1,42,31,1,6,81
21005,C132,2,39,50,0,4,95
21005,C133,0,17,19,0,4,40
21005,C134,2,62,76,0,0,140
21005,C135,1,38,49,0,3,91
21005,C136,2,28,42,0,2,74
21005,C137,3,52,64,0,2,121
21017,B101,5,92,61,0,10,168
21017,B103,2,55,52,0,6,115
21017,C101,0,57,34,0,8,99
21017,C102,2,22,24,0,4,52
21017,C103,0,63,86,1,5,155
21017,D101,8,102,83,1,10,204
21017,D103,2,51,38,0,7,98
21017,E101,4,84,79,0,11,178
21017,E103,1,65,78,0,13,157
21017,F101,3,55,64,0,16,138
21017,F102,3,61,62,1,11,138
21017,F103,1,47,33,0,2,83
21017,G101,3,72,85,0,11,171
21017,G102,2,84,84,2,7,179
21017,H101,4,89,87,0,12,192
21017,H102,1,51,97,0,3,152
21019,A101,2,66,77,1,7,153
21019,A107,4,73,60,0,7,144
21019,A108,6,85,58,1,16,166
21019,A109,5,70,77,0,5,157
21019,A110,0,54,45,1,9,109
21019,A111,0,46,46,1,13,106
21019,A113,1,56,40,1,11,109
21019,A114,0,16,12,0,3,31
21019,A115,0,64,54,0,9,127
21019,A116,1,57,50,0,9,117
21019,A118,4,59,50,0,12,125
21019,A119,0,52,39,0,2,93
21019,A121,2,51,36,1,1,91
21019,A122,1,4,0,0,1,6
21019,B101,0,35,40,0,6,81
21019,B102,0,53,52,1,10,116
21019,B103,1,41,38,1,5,86
21019,B105,0,36,33,0,5,74
21019,B106,1,54,54,0,11,120
21019,B107,2,42,40,0,9,93
21019,B108,0,65,51,0,5,121
21019,B109,0,58,61,0,12,131
21019,B110,2,76,79,1,8,166
21019,B114,2,61,65,0,11,139
21019,B115,0,79,81,0,20,180
21019,B116,0,53,40,0,6,99
21019,B117,1,34,56,0,7,98
21019,B118,1,44,18,0,11,74
21019,B119,2,34,40,1,5,82
21019,B121,0,40,64,0,12,116
21019,C102,4,49,26,0,10,89
21019,C103,2,33,32,0,5,72
21019,C104,6,64,44,0,10,124
21019,C105,5,43,43,0,6,97
21019,C106,3,50,51,1,8,113
21019,C107,1,27,29,0,6,63
21019,C108,1,49,28,0,3,81
21019,C109,0,23,37,1,2,63
21019,C110,0,0,0,0,0,0
21019,C111,0,12,21,0,1,34
21019,C113,6,87,93,1,15,202
21019,C114,2,45,27,0,4,78
21019,C115,1,57,74,0,14,146
21019,C116,0,44,39,0,4,87
21019,C117,2,40,33,1,2,78
21021,A101,3,78,50,2,11,144
21021,A102,2,79,68,1,8,158
21021,A103,3,39,29,2,3,76
21021,A104,2,64,40,2,10,118
21021,A105,0,13,27,0,2,42
21021,B101,1,26,16,0,3,46
21021,B102,4,63,45,0,6,118
21021,B103,1,81,82,0,15,179
21021,B104,2,63,49,1,9,124
21021,C101,1,59,77,1,5,143
21021,C102,0,60,81,0,5,146
21021,C103,0,19,37,0,1,57
21021,C104,1,26,68,0,1,96
21021,D101,3,72,124,1,4,204
21021,D102,1,76,92,1,5,175
21021,D103,3,79,80,1,11,174
21021,E101,1,73,81,0,6,161
21021,E102,0,67,82,0,5,154
21021,E103,0,49,56,0,1,106
21021,E104,0,70,91,0,1,162
21021,F101,2,52,64,1,9,128
21021,F102,1,68,61,0,9,139
21021,F103,4,49,68,0,6,127
21021,F104,4,50,66,0,6,126
21021,F105,1,28,43,0,3,75
21023,A101,2,58,26,1,3,90
21023,B101,5,45,27,1,4,82
21023,C101,4,40,39,1,7,91
21023,D101,2,52,28,1,8,91
21023,E101,5,54,27,0,7,93
21023,F101,6,66,25,1,10,108
21023,G101,4,45,29,2,5,85
21025,H101,3,47,25,1,11,87
21025,A101,0,31,29,1,5,66
21025,A102,4,98,49,3,18,172
21025,A103,6,159,90,4,35,294
21025,A104,5,109,71,1,30,216
21025,A105,5,63,57,3,11,139
21025,B101,6,50,38,4,18,116
21025,B102,4,96,27,0,20,147
21025,B103,1,95,71,2,17,186
21025,B104,1,78,93,1,9,182
21025,B105,2,52,48,1,6,109
21025,C101,3,109,86,0,26,224
21025,C102,1,71,35,0,13,120
21025,C103,0,102,66,4,30,202
21025,C104,3,84,27,1,18,133
21025,C105,2,68,43,1,11,125
21025,D101,0,41,37,0,8,86
21025,D102,1,80,58,2,26,167
21025,D103,7,128,54,0,21,210
21025,D104,0,66,37,3,18,124
21025,D105,1,24,10,0,9,44
21025,D106,1,65,48,1,15,130
21027,A101,1,78,108,1,8,196
21027,A102,4,59,58,0,8,129
21027,B101,4,49,45,2,5,105
21027,B102,3,50,58,0,4,115
21027,B103,2,67,45,0,6,120
21027,C101,2,56,59,0,12,129
21027,C102,2,66,59,0,7,134
21027,D101,2,66,73,0,9,150
21027,D102,1,44,73,0,5,123
21027,D103,1,28,21,0,5,55
21027,E101,3,53,19,0,7,82
21027,E102,3,39,41,1,3,87
21027,E103,2,23,39,0,4,68
21027,F101,4,104,105,0,18,231
21027,F102,1,28,13,1,2,45
21027,F103,0,33,24,0,5,62
21029,A101,0,15,9,0,1,25
21029,A102,3,50,47,2,3,105
21029,A103,0,58,33,0,2,93
21029,A104,1,66,53,0,5,125
21029,A105,2,105,57,2,12,178
21029,A106,2,92,45,2,9,150
21029,A107,4,115,95,0,17,231
21029,A108,1,47,57,0,2,107
21029,A110,0,13,9,1,1,24
21029,A111,3,65,59,1,5,133
21029,A112,2,88,75,0,10,175
21029,A113,1,90,66,1,10,168
21029,B101,0,32,28,0,0,60
21029,B102,5,72,75,0,4,156
21029,B103,3,86,95,2,10,196
21029,B104,2,75,105,0,11,193
21029,B108,2,92,124,0,6,224
21029,B109,4,93,83,0,10,190
21029,B110,2,87,78,0,4,171
21029,B111,1,87,67,0,8,163
21029,B112,1,22,35,0,3,61
21029,B113,3,84,60,1,7,155
21029,B114,2,61,47,1,1,112
21029,C101,1,61,65,0,4,131
21029,C102,2,69,69,1,6,147
21029,C103,3,65,78,1,10,157
21029,C104,3,61,42,1,4,111
21029,C105,0,70,53,0,6,129
21029,C106,0,59,50,0,5,114
21029,C107,2,88,67,1,10,168
21029,C108,2,74,87,0,8,171
21029,C109,1,63,39,1,7,111
21029,C110,1,57,85,0,7,150
21029,C111,1,12,31,0,0,44
21029,C112,0,45,47,0,2,94
21029,C113,1,54,33,0,3,91
21029,D101,1,32,32,0,1,66
21029,D102,3,75,77,0,10,165
21029,D103,2,88,94,0,3,187
21029,D104,0,41,11,0,1,53
21029,D105,6,92,79,0,18,195
21029,D106,4,74,61,0,16,155
21029,D107,4,115,75,1,9,204
21029,D108,2,87,67,0,7,163
21029,D110,5,79,88,0,8,180
21029,D111,1,48,56,0,9,114
21029,D113,2,15,10,0,4,31
21029,D114,0,23,19,1,1,44
21031,A110,0,17,13,0,0,30
21031,A111,1,17,20,0,1,39
21031,B106,0,12,30,0,2,44
21031,B107,0,46,34,1,3,84
21031,C103,0,1,2,0,1,4
21031,C106,1,27,28,1,2,59
21031,C107,3,15,30,0,5,53
21031,D103,1,10,19,0,1,31
21031,D105,0,7,9,0,0,16
21031,D106,0,17,19,0,1,37
21031,E105,1,15,16,0,2,34
21031,E106,1,8,10,0,3,22
21033,A101,4,69,41,2,19,135
21033,A102,1,40,14,0,4,59
21033,A103,2,99,66,0,8,175
21033,B101,6,72,41,3,21,143
21033,B102,0,59,21,0,8,88
21033,B103,2,52,60,1,3,118
21033,C101,2,83,47,2,14,148
21033,C102,1,50,21,1,11,84
21033,C103,5,76,58,2,18,159
21033,D101,1,52,24,0,12,89
21033,D102,2,37,25,1,5,70
21033,D103,4,101,76,0,29,210
21033,D104,3,56,54,0,21,134
21035,A101,0,116,80,0,2,198
21035,A102,0,28,21,0,2,51
21035,A103,3,142,74,0,21,240
21035,A104,5,71,33,0,8,117
21035,A105,1,67,34,0,13,115
21035,A106,2,62,31,1,3,99
21035,B101,0,75,55,2,7,139
21035,B103,3,47,41,0,12,103
21035,B104,0,54,30,1,8,93
21035,B105,0,118,53,1,7,179
21035,B107,3,69,44,3,10,129
21035,B108,2,23,35,0,2,62
21035,B109,0,113,46,0,7,166
21035,C101,3,97,57,2,16,175
21035,C102,9,140,95,2,17,263
21035,C103,5,62,46,0,8,121
21035,C104,3,69,32,1,14,119
21035,C105,1,57,72,1,8,139
21035,C106,2,87,49,1,8,147
21035,C107,1,38,33,1,3,76
21035,C108,2,72,38,0,5,117
21035,C109,1,44,72,0,9,126
21035,C110,1,39,25,0,5,70
21035,D102,8,60,46,1,13,128
21035,D103,0,64,45,2,8,119
21035,D104,0,39,31,0,12,82
21035,D105,6,162,76,0,26,270
21035,D106,0,43,26,0,11,80
21035,D108,0,114,50,0,7,171
21037,A801,1,37,34,0,3,75
21037,A802,0,27,23,0,4,54
21037,A803,0,35,46,0,6,87
21037,A804,0,44,43,0,2,89
21037,B805,0,48,42,0,2,92
21037,B806,1,55,59,0,4,119
21037,B807,2,36,36,0,7,81
21037,C201,2,87,66,0,2,157
21037,C202,3,43,56,0,5,107
21037,C203,1,68,65,0,4,138
21037,C204,1,84,62,0,2,149
21037,B902,7,27,43,0,7,84
21037,B906,4,54,46,0,6,110
21037,B905,1,54,72,1,11,139
21037,A701,0,33,28,1,5,67
21037,B702,4,56,30,0,2,92
21037,A703,1,71,66,1,4,143
21037,B704,1,47,67,0,2,117
21037,B705,0,32,33,0,3,68
21037,B706,0,60,116,0,5,181
21037,C101,0,55,37,0,2,94
21037,C102,0,51,48,1,8,108
21037,C103,0,53,50,0,1,104
21037,C401,1,28,44,1,2,76
21037,A402,0,51,72,0,6,129
21037,A403,0,57,69,0,2,128
21037,A405,0,59,47,0,1,107
21037,A406,0,17,8,0,1,26
21037,A408,3,72,70,0,3,148
21037,A415,0,19,27,1,1,48
21037,C416,0,31,50,0,1,82
21037,A409,0,49,50,0,1,100
21037,A410,0,51,52,0,0,103
21037,A411,0,18,18,0,1,37
21037,A412,0,61,49,1,4,115
21037,A414,0,42,28,0,0,70
21037,A418,1,85,75,1,7,169
21037,A419,0,25,27,0,2,54
21037,A417,0,0,0,0,0,0
21037,B904,1,73,43,0,7,124
21037,A601,0,40,23,0,1,64
21037,A602,0,42,15,0,2,59
21037,A603,0,17,16,0,0,33
21037,A604,0,32,19,0,0,51
21037,A605,2,79,94,0,1,176
21037,B909,0,62,66,0,6,134
21037,B910,2,14,48,0,2,66
21037,B901,1,17,46,0,5,69
21037,C301,0,62,74,0,3,139
21037,C302,1,77,73,0,1,152
21037,C303,1,24,35,1,2,63
21037,C304,1,48,71,0,2,122
21037,C305,0,49,24,0,0,73
21037,C306,0,20,30,0,4,54
21037,C307,0,23,22,0,3,48
21037,C308,0,52,74,0,3,129
21037,C309,0,47,47,1,7,102
21037,C310,1,42,49,0,3,95
21037,C311,0,63,41,0,0,104
21037,B907,0,28,24,0,3,55
21037,B912,0,34,31,0,2,67
21037,C501,0,36,37,1,2,76
21037,A502,0,63,42,0,3,108
21037,A503,0,14,10,1,1,26
21037,A504,0,39,28,0,3,70
21037,B903,2,52,47,0,8,109
21037,B913,0,51,48,0,3,102
21039,A101,4,86,38,1,17,146
21039,A102,2,74,28,3,15,122
21039,B101,4,81,48,0,29,162
21039,B102,3,38,15,1,13,70
21039,C101,3,91,34,0,10,138
21039,C102,2,76,38,0,27,143
21041,A101,0,50,39,0,8,97
21041,A102,0,78,68,1,7,154
21041,A103,0,58,55,0,8,121
21041,B101,2,40,50,0,6,98
21041,B102,1,59,61,0,4,125
21041,B103,0,47,36,0,10,93
21041,B104,1,23,21,1,5,51
21041,C101,0,14,6,0,3,23
21041,C102,2,22,13,1,9,47
21041,C103,1,62,24,1,5,93
21041,C104,1,107,91,3,17,219
21043,A101,5,60,33,2,4,104
21043,A102,0,44,16,0,3,63
21043,A103,0,24,25,0,2,51
21043,A104,2,29,27,1,5,64
21043,A105,1,51,47,0,7,106
21043,B101,0,63,41,1,16,121
21043,B102,3,19,18,0,2,42
21043,B103,2,42,30,1,11,86
21043,B104,4,33,35,0,5,77
21043,B105,2,50,37,2,7,98
21043,C101,1,73,72,3,9,158
21043,C102,1,8,14,0,1,24
21043,C103,2,52,31,0,9,94
21043,C104,3,50,43,2,3,101
21043,D101,2,24,25,0,2,53
21043,D102,0,13,19,0,1,33
21043,D103,0,24,36,0,2,62
21043,D104,3,44,21,0,2,70
21043,D105,1,25,16,0,3,45
21043,D106,1,49,37,0,8,95
21043,D107,1,39,34,0,9,83
21043,E101,0,34,10,0,3,47
21043,E102,0,29,21,0,7,57
21043,E103,1,45,39,2,5,92
21043,E104,3,61,26,0,4,94
21043,E105,1,46,23,0,4,74
21047,A101,0,14,52,0,2,68
21047,A102,0,18,115,0,2,135
21047,A103,1,34,196,0,1,232
21047,A104,1,43,94,0,7,145
21047,A105,2,20,74,0,8,104
21047,B101,2,92,118,0,19,231
21047,B102,3,69,143,1,6,222
21047,B103,5,53,32,1,9,100
21047,B104,2,31,22,1,6,62
21047,C101,1,33,37,1,4,76
21047,C102,0,19,78,0,2,99
21047,C103,3,42,45,1,7,98
21047,C104,2,43,47,2,16,110
21047,C105,6,114,60,4,31,215
21047,C106,1,48,47,0,9,105
21047,D101,3,64,69,1,11,148
21047,D102,3,59,56,1,14,133
21047,D103,3,57,66,1,12,139
21047,D104,1,35,14,0,9,59
21047,D105,0,26,13,0,8,47
21047,D106,1,34,11,0,5,51
21047,D107,3,83,89,1,16,192
21047,E101,1,28,69,0,2,100
21047,E102,2,89,82,0,16,189
21047,E103,1,72,70,1,16,160
21047,E104,0,35,65,0,13,113
21047,E105,1,34,25,0,7,67
21047,F101,0,25,6,0,3,34
21047,F102,1,61,84,0,10,156
21047,F103,1,21,10,1,3,36
21047,F104,0,34,37,0,1,72
21047,G101,5,50,43,0,14,112
21047,G102,0,16,12,0,0,28
21047,G103,3,31,49,0,3,86
21047,G104,7,73,74,0,3,157
21047,G105,0,8,5,0,0,13
21047,G106,5,55,57,0,9,126
21047,H101,2,43,29,0,11,85
21047,H102,5,72,51,0,16,144
21047,H103,2,48,92,0,15,157
21047,H104,6,68,33,0,13,120
21049,A101,4,120,115,0,16,255
21049,A102,3,77,62,3,14,159
21049,A103,1,103,80,0,7,191
21049,A104,1,103,86,1,10,201
21049,B101,2,64,67,1,14,148
21049,B102,3,124,95,0,13,235
21049,B103,0,35,47,0,5,87
21049,B104,2,67,41,2,7,119
21049,B105,2,84,50,2,9,147
21049,C101,0,78,78,2,8,166
21049,C102,5,71,75,0,3,154
21049,C103,4,94,59,2,16,175
21049,C104,0,78,69,0,14,161
21049,D101,2,12,19,0,1,34
21049,D102,2,95,105,0,6,208
21049,D103,1,63,54,0,9,127
21049,D104,3,70,116,1,7,197
21049,E101,1,71,46,0,6,124
21049,E102,1,136,133,1,14,285
21049,E103,2,36,39,0,8,85
21049,F101,1,30,85,0,1,117
21049,F102,2,43,35,2,1,83
21049,F103,1,72,52,0,7,132
21049,F104,0,14,68,0,2,84
21049,F105,1,62,43,0,4,110
21049,F106,0,50,45,0,5,100
21051,A101,1,17,31,0,4,53
21051,A106,0,10,9,0,2,21
21051,A107,0,8,12,0,0,20
21051,B101,1,15,4,1,2,23
21051,B103,0,7,17,0,1,25
21051,B104,0,13,10,1,3,27
21051,C101,0,5,4,0,0,9
21051,C102,0,5,1,0,2,8
21051,C103,0,3,5,0,0,8
21051,C104,0,4,8,1,1,14
21051,D102,0,3,11,0,3,17
21051,D103,0,9,8,0,2,19
21051,D104,1,6,6,0,1,14
21051,E101,0,7,1,0,0,8
21051,E102,1,4,9,0,1,15
21051,E103,0,10,14,0,1,25
21051,E104,0,3,3,0,0,6
21051,F101,0,7,6,0,3,16
21051,F102,0,9,7,0,0,16
21051,F104,0,10,7,1,0,18
21053,A101,0,4,14,0,1,19
21053,A104,1,8,9,0,0,18
21053,B101,0,12,8,0,1,21
21053,B102,0,5,3,0,1,9
21053,C101,1,10,18,0,1,30
21053,C102,0,12,8,0,0,20
21053,C103,1,10,16,1,2,30
21053,D101,0,5,7,0,1,13
21053,D102,0,3,5,1,1,10
21053,E101,1,4,10,0,0,15
21053,E102,0,5,14,0,1,20
21053,F101,0,5,9,0,2,16
21053,F102,0,4,10,0,0,14
21055,A101,2,33,27,1,6,69
21055,A102,1,22,16,0,3,42
21055,B101,0,44,21,0,6,71
21055,B102,1,44,24,2,6,77
21055,C101,0,28,22,1,2,53
21055,C102,0,14,10,0,4,28
21055,D101,0,20,26,0,8,54
21055,D102,0,12,5,1,0,18
21055,E101,4,30,20,0,5,59
21055,E102,2,32,18,1,7,60
21055,F101,1,24,26,2,10,63
21055,F102,1,29,16,0,7,53
21057,A101,0,9,6,0,1,16
21057,A102,0,4,14,0,1,19
21057,B101,0,3,7,0,0,10
21057,B102,1,5,1,0,0,7
21057,B103,0,6,3,0,0,9
21057,C101,0,7,5,0,1,13
21057,C102,0,16,9,0,1,26
21057,C103,0,1,4,0,1,6
21057,D101,0,21,9,0,1,31
21057,D102,0,8,14,0,1,23
21059,A101,2,42,29,1,6,80
21059,A102,0,38,34,1,1,74
21059,A103,0,59,83,0,7,149
21059,A104,0,79,52,0,5,136
21059,A105,4,87,92,1,13,197
21059,A106,0,60,57,0,6,123
21059,A107,0,39,29,0,3,71
21059,A108,1,34,33,0,4,72
21059,A109,3,68,59,0,9,139
21059,A110,1,68,44,0,8,121
21059,A111,1,80,54,0,7,142
21059,A112,1,39,95,1,1,137
21059,A113,0,61,31,0,4,96
21059,A114,0,64,79,0,3,146
21059,A115,4,37,76,0,7,124
21059,A116,0,76,74,2,14,166
21059,A118,0,38,35,0,2,75
21059,A119,2,71,36,0,6,115
21059,A120,3,69,56,0,2,130
21059,A121,1,44,38,1,3,87
21059,A122,1,28,43,1,4,77
21059,A123,3,37,67,2,4,113
21059,A124,1,86,82,0,5,174
21059,A125,2,51,57,2,6,118
21059,A126,0,50,61,2,3,116
21059,A127,3,45,68,0,5,121
21059,A128,0,63,54,1,4,122
21059,A129,2,44,60,0,3,109
21059,A130,0,61,50,0,5,116
21059,A131,1,53,53,1,10,118
21059,A132,0,76,61,0,8,145
21059,A133,0,52,55,2,11,120
21059,A134,4,53,85,1,8,151
21059,A135,0,44,41,2,2,89
21059,A136,1,59,56,0,11,127
21059,A137,5,51,57,0,5,118
21059,A138,2,76,68,0,10,156
21059,A139,2,74,85,0,12,173
21059,A140,0,40,50,1,10,101
21059,A141,3,52,53,1,4,113
21059,A142,1,78,88,0,2,169
21059,A143,1,55,36,0,4,96
21059,A144,2,50,44,0,1,97
21059,A145,2,33,48,0,3,86
21059,A146,2,95,88,0,9,194
21059,A147,4,63,61,0,9,137
21059,A148,3,41,61,0,4,109
21059,B101,2,69,76,2,8,157
21059,B102,3,109,108,1,17,238
21059,B103,2,59,42,0,5,108
21059,B104,4,76,66,0,14,160
21059,C101,2,112,120,0,20,254
21059,C102,4,62,61,5,29,161
21059,D102,2,91,81,1,15,190
21059,D103,5,32,30,0,2,69
21059,E101,1,81,41,0,16,139
21059,E102,7,50,52,0,14,123
21059,E103,3,88,59,0,15,165
21059,E104,1,19,14,0,2,36
21059,F101,3,86,88,1,5,183
21059,F102,1,99,90,1,12,203
21059,F103,1,73,51,0,17,142
21059,F104,1,66,60,0,7,134
21059,G101,3,62,36,1,13,115
21059,G102,1,47,47,0,7,102
21059,G103,1,63,52,0,7,123
21059,G104,5,94,41,0,16,156
21059,G105,3,30,28,2,10,73
21059,H101,2,33,34,0,3,72
21059,H102,5,69,90,2,15,181
21059,H103,4,78,61,0,12,155
21059,H104,3,48,55,0,9,115
21059,H105,2,57,70,2,5,136
21059,H106,0,26,22,0,2,50
21059,H107,1,70,59,1,11,142
21059,H108,0,16,15,0,1,32
21059,H109,4,53,53,1,5,116
21059,H110,1,31,25,0,6,63
21059,H111,2,65,92,0,5,164
21059,H112,0,79,70,2,13,164
21059,H113,0,44,33,0,5,82
21059,H114,2,37,32,0,5,76
21059,H115,6,104,88,2,21,221
21059,H116,0,22,15,0,3,40
21059,H117,4,93,108,0,5,210
21061,A101,0,55,42,0,3,100
21061,B101,0,32,39,0,2,73
21061,C101,0,13,10,0,0,23
21061,C102,2,35,21,0,0,58
21061,D101,0,38,39,0,4,81
21061,E101,0,39,47,0,2,88
21061,F101,2,45,66,0,3,116
21063,A101,1,47,33,0,6,87
21063,B101,3,55,28,2,13,101
21063,C101,4,75,25,2,12,118
21063,D101,1,104,66,0,11,182
21063,E101,2,52,48,2,9,113
21063,F101,5,50,35,0,9,99
21063,G101,1,42,29,1,11,84
21065,A101,1,18,20,0,0,39
21065,A102,2,21,17,0,2,42
21065,A103,0,12,24,0,2,38
21065,A104,2,14,21,0,1,38
21065,A105,1,22,24,0,3,50
21065,A106,0,22,39,0,2,63
21065,B102,0,25,34,0,6,65
21065,B103,0,23,10,0,1,34
21065,B104,1,16,24,0,2,43
21065,B105,1,83,59,0,6,149
21065,B106,0,19,12,1,0,32
21065,C103,1,44,48,0,4,97
21065,C104,0,32,19,0,2,53
21065,C105,0,23,25,0,1,49
21065,C106,2,58,48,1,1,110
21067,A101,0,63,61,2,0,126
21067,A102,1,75,88,0,1,165
21067,A103,1,56,55,0,1,113
21067,A104,0,22,25,0,1,48
21067,A106,0,26,49,1,1,77
21067,A108,1,21,25,0,3,50
21067,A109,2,35,170,0,0,207
21067,A111,3,75,71,0,3,152
21067,A113,0,55,62,0,2,119
21067,A114,0,71,30,1,2,104
21067,A115,3,63,186,0,1,253
21067,A116,0,41,79,0,2,122
21067,A117,0,106,116,1,0,223
21067,A118,1,50,73,0,3,127
21067,A120,0,21,110,0,0,131
21067,A121,1,46,51,0,6,104
21067,A123,2,58,81,0,3,144
21067,A126,0,33,120,0,1,154
21067,A128,0,76,104,0,4,184
21067,A130,0,36,134,0,1,171
21067,A131,1,62,58,0,4,125
21067,A132,1,108,59,0,2,170
21067,A133,0,64,109,0,2,175
21067,A134,0,31,91,0,1,123
21067,A135,0,42,124,0,3,169
21067,A136,2,94,73,0,2,171
21067,A138,0,89,108,0,3,200
21067,A139,0,71,67,0,4,142
21067,A140,0,51,76,0,3,130
21067,A143,0,41,59,0,1,101
21067,A144,0,54,139,0,0,193
21067,A145,0,98,77,2,2,179
21067,A146,0,105,71,0,2,178
21067,A148,0,114,112,1,2,229
21067,A149,1,43,86,0,0,130
21067,A150,0,106,107,0,1,214
21067,A151,1,62,56,0,1,120
21067,A152,0,93,107,0,2,202
21067,A155,1,56,162,1,0,220
21067,A156,1,39,50,2,1,93
21067,A157,0,60,90,0,2,152
21067,A158,0,37,58,0,1,96
21067,A161,1,113,106,0,0,220
21067,A162,1,21,25,0,0,47
21067,A163,0,49,46,0,4,99
21067,A164,0,25,108,0,1,134
21067,A165,0,24,65,1,4,94
21067,A166,1,52,75,0,4,132
21067,A167,1,53,59,0,3,116
21067,A168,0,58,142,0,3,203
21067,A169,0,70,82,0,2,154
21067,A170,1,39,29,1,0,70
21067,A171,1,54,82,0,1,138
21067,A172,1,70,52,0,1,124
21067,A173,0,93,18,0,0,111
21067,A174,0,26,26,0,0,52
21067,A175,0,16,37,0,0,53
21067,A176,0,31,60,0,3,94
21067,A177,1,54,98,0,0,153
21067,A178,1,37,25,0,2,65
21067,A179,0,36,96,0,0,132
21067,A180,0,38,47,0,0,85
21067,A181,3,65,120,0,1,189
21067,A182,1,58,48,0,5,112
21067,A183,0,67,55,0,4,126
21067,A184,0,34,9,0,0,43
21067,A185,1,71,54,0,0,126
21067,A187,0,122,96,0,0,218
21067,A188,2,37,76,0,0,115
21067,A189,2,42,57,0,1,102
21067,A190,0,48,59,0,0,107
21067,A191,0,88,101,0,4,193
21067,A192,0,47,80,1,1,129
21067,A193,0,48,55,0,4,107
21067,A194,1,49,73,0,1,124
21067,A195,1,54,56,1,0,112
21067,A196,0,51,54,0,0,105
21067,A197,0,66,78,0,0,144
21067,A198,1,47,58,0,0,106
21067,A199,1,42,56,0,1,100
21067,A200,1,92,120,1,2,216
21067,A201,1,57,74,0,1,133
21067,A203,0,1,1,0,0,2
21067,A204,1,38,47,1,1,88
21067,B101,3,50,63,0,2,118
21067,B102,0,117,103,0,6,226
21067,B103,0,49,49,0,4,102
21067,B104,0,78,44,0,3,125
21067,B105,2,64,73,1,4,144
21067,B106,1,53,48,0,7,109
21067,B108,0,60,52,0,3,115
21067,B110,1,64,64,0,1,130
21067,B111,1,55,57,0,1,114
21067,B112,0,58,83,0,2,143
21067,B113,0,158,112,1,2,273
21067,B114,1,86,49,0,4,140
21067,B117,1,70,78,2,2,153
21067,B118,1,96,62,2,1,162
21067,B119,1,29,49,0,0,79
21067,B120,1,34,41,0,3,79
21067,B121,1,50,63,0,2,116
21067,B123,0,49,85,1,5,140
21067,B125,0,83,75,0,0,158
21067,B127,0,77,67,0,2,146
21067,B128,0,48,74,0,2,124
21067,B129,0,62,37,0,5,104
21067,B130,1,85,66,0,4,156
21067,B132,0,97,59,1,1,158
21067,B133,0,72,58,0,1,131
21067,B135,2,111,79,1,2,195
21067,B137,0,72,108,0,2,182
21067,B138,0,83,146,0,1,230
21067,B139,1,41,84,0,4,130
21067,B140,0,68,68,0,1,137
21067,B141,1,74,63,0,2,140
21067,B142,1,50,56,0,2,109
21067,B143,1,73,89,0,3,166
21067,B146,1,78,43,0,4,126
21067,B147,0,84,76,0,1,161
21067,B150,4,68,57,0,5,134
21067,B151,0,49,58,0,5,112
21067,B152,0,46,86,0,3,135
21067,B154,1,58,64,0,4,127
21067,B155,1,74,85,2,6,168
21067,B156,3,69,86,0,8,166
21067,B157,0,59,31,0,0,90
21067,B158,2,60,53,0,3,118
21067,B159,0,71,69,0,5,145
21067,B163,0,71,71,0,6,148
21067,B164,1,45,43,0,3,92
21067,B165,2,97,72,0,4,175
21067,B166,0,50,93,0,3,146
21067,B167,0,39,41,0,3,83
21067,B168,0,63,89,0,1,153
21067,B169,2,40,43,0,4,89
21067,B170,1,54,51,0,1,107
21067,B172,1,35,47,0,2,85
21067,B174,0,46,41,0,1,88
21067,B179,3,89,79,0,3,174
21067,B181,2,55,100,0,2,159
21067,B182,0,31,55,0,1,87
21067,B183,0,47,92,1,3,143
21067,B184,0,51,81,0,6,138
21067,B185,1,64,87,0,7,159
21067,B186,0,63,49,0,2,114
21067,B187,1,60,38,0,4,103
21067,B188,1,46,95,0,0,142
21067,B189,0,61,60,0,1,122
21067,B190,0,69,77,0,0,146
21067,B191,0,45,42,0,4,91
21067,B192,1,47,81,0,8,137
21067,B195,0,86,70,0,5,161
21067,B196,0,64,45,0,3,112
21067,B197,0,45,63,0,2,110
21067,B198,0,42,69,1,3,115
21067,B199,1,54,74,0,5,134
21067,B200,1,39,35,1,2,78
21067,B201,1,27,47,0,1,76
21067,B202,0,61,80,0,2,143
21067,B203,0,62,55,0,2,119
21067,B204,0,35,47,0,1,83
21067,B205,2,61,78,0,3,144
21067,B206,1,38,65,0,3,107
21067,B207,1,56,74,1,2,134
21067,B208,3,42,35,0,1,81
21067,B209,0,58,67,0,1,126
21067,B210,0,54,53,0,0,107
21067,B211,0,88,47,0,0,135
21067,B212,0,62,59,0,4,125
21067,B213,1,38,30,0,1,70
21067,B215,0,40,69,1,5,115
21067,B216,2,46,61,0,1,110
21067,B217,1,18,33,2,0,54
21067,B218,0,51,72,0,8,131
21067,B219,2,44,43,0,2,91
21067,B221,1,35,48,0,3,87
21067,B222,0,65,75,0,4,144
21067,B223,1,56,34,0,3,94
21067,B224,0,50,73,1,3,127
21067,B225,0,51,49,0,2,102
21067,B226,3,53,34,0,4,94
21067,B227,1,46,36,0,2,85
21067,B228,1,21,50,0,0,72
21067,B229,1,65,89,1,0,156
21067,B230,0,16,16,0,0,32
21067,B231,0,92,87,1,2,182
21067,B232,0,47,73,0,2,122
21067,C102,0,23,30,0,2,55
21067,C103,0,97,168,0,1,266
21067,C105,1,160,56,0,1,218
21067,C109,0,40,40,1,1,82
21067,C113,0,71,151,0,1,223
21067,C114,2,29,67,0,1,99
21067,C115,0,82,33,0,0,115
21067,C118,1,56,57,0,4,118
21067,C120,0,68,108,0,3,179
21067,C121,0,18,33,0,3,54
21067,C124,0,112,119,0,4,235
21067,C125,5,66,67,0,2,140
21067,C126,1,85,63,0,1,150
21067,C127,2,61,75,0,2,140
21067,C128,1,133,49,0,0,183
21067,C129,0,42,40,0,1,83
21067,C130,2,52,84,1,0,139
21067,C132,0,90,64,1,4,159
21067,C137,1,39,69,0,3,112
21067,C138,1,158,124,0,3,286
21067,C140,0,188,175,0,1,364
21067,C142,0,169,185,0,1,355
21067,C143,0,44,74,0,1,119
21067,C144,0,57,81,0,2,140
21067,C148,3,67,54,0,0,124
21067,C150,0,43,58,1,2,104
21067,C151,0,43,41,0,1,85
21067,C152,0,41,99,0,0,140
21067,C153,0,52,39,0,4,95
21067,C154,2,34,39,0,0,75
21067,C155,2,31,45,0,2,80
21067,C156,0,83,60,3,3,149
21067,C157,1,65,47,0,0,113
21067,C159,1,41,67,0,2,111
21067,C160,0,28,33,0,0,61
21067,C161,1,58,52,0,1,112
21067,C162,2,72,56,0,2,132
21067,C163,0,35,41,0,0,76
21067,C164,2,80,71,0,4,157
21067,C165,0,73,75,0,4,152
21067,C167,1,85,73,1,1,161
21067,C170,1,67,51,0,1,120
21067,C171,0,54,45,0,2,101
21067,C173,2,49,78,0,3,132
21067,C174,0,57,64,0,0,121
21067,C175,0,76,50,1,0,127
21067,C176,0,63,81,0,3,147
21067,C177,0,99,53,0,0,152
21067,C178,0,32,56,0,1,89
21067,C179,0,54,46,1,2,103
21067,C180,0,51,88,0,4,143
21067,C182,2,46,57,1,2,108
21067,C183,0,41,32,0,0,73
21067,C184,2,22,17,0,0,41
21067,C185,1,21,12,0,1,35
21067,C186,1,67,59,0,1,128
21067,C187,0,31,59,0,2,92
21067,C188,0,57,48,0,4,109
21067,C189,0,67,54,0,2,123
21067,C190,0,63,52,0,1,116
21067,C191,1,103,90,0,3,197
21067,C192,0,39,55,0,0,94
21067,C193,0,14,38,0,1,53
21067,C194,1,46,74,0,3,124
21067,C195,0,48,51,0,3,102
21067,C196,0,68,54,0,1,123
21067,C197,0,36,28,0,1,65
21067,C198,0,44,39,0,5,88
21067,C199,1,35,51,0,3,90
21067,C200,2,45,69,0,1,117
21067,C201,0,23,42,0,1,66
21067,C203,0,38,71,0,2,111
21067,C205,1,68,84,0,2,155
21067,C207,1,76,111,0,3,191
21067,C208,0,23,56,0,4,83
21067,C209,0,41,49,0,0,90
21067,C210,0,26,72,0,2,100
21067,C211,2,57,55,1,2,117
21067,C212,0,60,57,0,0,117
21067,C213,0,35,32,0,2,69
21067,C215,0,38,55,0,1,94
21067,C216,2,35,53,0,3,93
21067,C217,0,44,48,0,0,92
21067,C218,0,35,56,0,3,94
21067,C219,0,35,66,0,0,101
21067,C220,0,41,51,0,1,93
21067,C221,2,52,58,1,0,113
21067,C222,0,49,58,0,0,107
21067,C223,0,69,96,2,1,168
21067,C224,0,38,62,0,1,101
21067,C225,2,55,50,2,6,115
21067,C226,0,37,43,0,1,81
21067,C227,0,59,66,0,1,126
21067,C228,1,44,50,0,1,96
21067,C229,0,28,26,0,1,55
21067,C230,0,40,52,0,0,92
21067,C231,1,31,73,0,0,105
21067,C232,0,48,47,0,3,98
21067,C233,0,53,62,1,2,118
21067,C235,0,39,34,0,0,73
21067,C236,1,26,38,0,0,65
21067,C237,2,28,47,0,0,77
21067,C238,1,51,69,0,1,122
21067,C239,0,53,98,0,2,153
21069,A101,2,85,40,1,4,132
21069,A102,1,26,24,0,3,54
21069,A103,1,39,34,0,5,79
21069,B101,1,34,19,1,1,56
21069,B102,3,72,42,0,7,124
21069,B103,1,20,20,0,3,44
21069,C101,3,55,29,0,4,91
21069,C102,3,72,60,0,5,140
21069,D102,1,54,69,1,4,129
21069,D103,1,51,58,1,7,118
21069,E101,1,32,40,0,2,75
21069,E102,0,34,32,0,5,71
21069,E103,0,27,12,0,2,41
21069,E104,0,22,11,0,4,37
21069,F102,1,40,26,0,7,74
21069,F103,2,21,17,0,7,47
21069,F104,3,64,48,1,3,119
21069,F105,0,37,25,0,5,67
21071,A101,4,98,55,1,17,175
21071,A102,4,25,10,0,3,42
21071,A103,5,100,53,1,23,182
21071,A104,2,70,29,2,4,107
21071,A105,5,117,65,0,24,211
21071,A106,5,121,67,1,27,221
21071,A107,3,104,52,1,21,181
21071,A109,4,144,66,3,21,238
21071,A110,4,101,49,1,21,176
21071,A111,4,106,61,2,15,188
21071,A113,5,150,48,3,33,239
21071,A116,6,155,63,3,34,261
21071,B101,2,97,41,3,16,159
21071,B102,11,133,78,1,31,254
21071,B103,5,91,31,1,18,146
21071,B104,5,86,53,0,20,164
21071,B105,3,96,71,2,23,195
21071,B106,7,146,66,0,37,256
21071,B108,0,119,47,1,19,186
21071,B109,1,30,16,0,10,57
21071,B112,3,127,63,1,27,221
21071,C101,5,94,47,0,21,167
21071,C102,8,71,51,1,13,144
21071,C103,3,101,64,4,19,191
21071,C104,5,141,108,0,29,283
21071,C105,2,36,21,0,19,78
21071,C106,4,68,26,1,14,113
21071,C107,1,91,57,3,27,179
21071,C108,0,94,70,5,14,183
21071,C109,2,83,56,0,19,160
21071,C110,4,40,52,1,10,107
21071,C111,4,61,25,2,14,106
21071,D101,5,77,88,3,15,188
21071,D102,2,105,67,2,26,202
21071,D103,2,73,50,2,19,146
21071,D104,2,87,46,3,25,163
21071,D105,0,32,33,1,6,72
21071,D106,2,92,62,2,24,182
21071,D107,6,117,65,1,18,207
21071,D108,5,165,65,3,35,273
21071,D109,1,30,48,0,6,85
21071,D110,2,47,28,2,11,90
21073,A101,8,184,189,2,27,410
21073,A102,4,102,97,0,18,221
21073,A103,1,116,114,1,5,237
21073,A104,3,99,111,0,14,227
21073,A105,1,149,114,1,5,270
21073,A106,2,113,77,2,10,204
21073,A107,1,131,147,1,7,287
21073,A108,4,130,110,0,24,268
21073,B101,6,136,203,0,18,363
21073,B102,1,112,172,1,15,301
21073,B103,3,102,84,2,16,207
21073,B105,5,99,70,2,28,204
21073,B106,17,319,307,4,39,686
21073,B108,0,128,112,2,12,254
21073,B109,1,43,36,1,4,85
21073,C101,1,81,67,1,13,163
21073,C102,1,59,99,0,6,165
21073,C105,3,84,78,0,16,181
21073,C106,7,108,74,0,28,217
21073,C107,1,181,210,0,15,407
21073,C108,3,157,143,3,16,322
21073,C109,3,158,198,1,21,381
21073,C110,3,97,99,1,16,216
21073,D101,0,102,72,2,14,190
21073,D102,9,165,115,4,35,328
21073,D103,0,79,36,1,15,131
21073,D104,5,95,78,1,13,192
21073,D105,3,66,50,1,8,128
21073,D106,0,48,49,1,4,102
21073,D107,2,89,78,2,6,177
21073,D108,4,57,60,2,14,137
21073,D109,1,43,61,0,2,107
21073,E101,3,164,176,3,20,366
21073,E102,6,298,253,5,41,603
21073,E108,0,130,134,0,23,287
21073,E109,4,92,134,1,13,244
21073,E110,1,104,99,0,18,222
21073,F101,5,103,60,2,10,180
21073,F102,0,92,73,0,4,169
21073,F103,5,123,76,1,22,227
21073,F104,6,144,116,0,14,280
21073,F105,2,73,134,0,14,223
21073,F106,6,108,77,2,13,206
21073,F108,12,198,165,5,41,421
21075,A101,1,19,27,0,6,53
21075,A102,1,13,35,0,6,55
21075,A103,0,12,12,0,1,25
21075,B101,3,39,10,0,17,69
21075,B102,2,45,42,1,9,99
21075,B104,2,37,22,4,7,72
21075,C102,2,19,31,1,18,71
21075,C103,1,7,74,0,4,86
21075,D101,1,23,30,0,11,65
21075,D102,2,10,9,0,5,26
21075,D103,1,13,14,0,6,34
21077,A101,2,72,67,1,9,151
21077,A102,2,39,37,1,4,83
21077,B101,1,33,17,0,8,59
21077,B102,2,31,27,0,1,61
21077,C101,1,34,20,1,3,59
21077,C102,1,38,24,0,2,65
21077,D101,1,44,21,0,6,72
21077,D102,2,44,34,0,5,85
21079,A101,0,20,22,0,2,44
21079,A103,0,37,39,0,2,78
21079,A104,1,36,51,0,1,89
21079,B101,0,11,34,0,1,46
21079,B102,1,27,45,1,2,76
21079,B103,0,7,17,0,0,24
21079,C102,1,45,33,0,5,84
21079,C103,0,31,46,0,5,82
21079,D101,2,18,17,0,1,38
21079,D102,0,17,13,0,4,34
21079,D103,0,26,22,0,1,49
21079,D104,1,20,23,1,3,48
21079,E101,0,35,46,1,2,84
21079,E103,1,43,10,0,0,54
21081,A101,1,56,39,1,5,102
21081,A102,1,35,15,0,5,56
21081,A103,2,50,33,0,2,87
21081,A104,5,18,27,0,1,51
21081,A105,5,53,37,0,3,98
21081,A106,2,24,23,0,2,51
21081,A107,0,37,50,0,5,92
21081,B101,3,49,37,2,8,99
21081,B102,0,17,10,0,2,29
21081,B103,0,13,14,0,6,33
21081,B104,1,25,20,0,6,52
21081,B105,3,47,34,0,5,89
21081,B106,1,21,18,0,4,44
21081,B107,3,48,23,0,8,82
21081,B108,2,21,30,0,2,55
21081,C101,1,23,12,0,1,37
21081,C102,1,27,15,1,4,48
21081,C103,0,31,47,0,8,86
21081,C104,5,24,15,1,1,46
21081,C106,2,17,19,0,1,39
21081,C107,2,41,33,2,8,86
21081,C108,0,26,14,0,3,43
21083,A101,1,47,22,2,14,86
21083,A102,5,83,28,0,16,132
21083,A103,4,89,50,0,25,168
21083,A104,1,56,26,1,13,97
21083,A105,3,74,40,1,33,151
21083,A106,7,89,44,1,17,158
21083,A107,4,104,53,3,34,198
21083,A108,4,86,31,1,36,158
21083,A109,6,148,72,4,50,280
21083,A110,4,100,58,1,29,192
21083,A111,6,117,67,3,44,237
21083,B101,2,33,37,0,9,81
21083,B102,1,28,34,0,7,70
21083,B103,2,62,72,1,19,156
21083,B104,1,51,36,1,20,109
21083,B105,1,96,75,0,20,192
21083,B106,2,23,27,0,10,62
21083,B107,2,37,41,0,9,89
21083,B108,3,90,74,2,35,204
21083,B109,2,56,70,0,13,141
21083,B110,12,139,75,2,32,260
21083,B111,3,104,59,3,32,201
21083,C101,7,129,102,1,26,265
21083,C102,3,130,51,2,35,221
21083,C104,2,147,54,2,31,236
21083,C106,1,89,36,1,19,146
21083,C107,4,66,27,0,13,110
21083,C108,1,109,63,1,18,192
21083,C109,1,86,50,1,18,156
21083,C110,3,113,78,1,29,224
21085,A102,0,22,23,0,3,48
21085,A103,1,59,61,0,6,127
21085,A104,1,8,9,1,1,20
21085,B101,0,17,28,0,5,50
21085,B102,1,8,2,0,1,12
21085,B103,0,28,30,0,3,61
21085,B104,1,11,19,0,2,33
21085,B105,4,62,54,0,2,122
21085,C101,0,7,18,0,2,27
21085,C102,0,43,45,0,2,90
21085,C103,0,68,60,1,4,133
21085,D101,4,50,80,0,4,138
21085,D102,0,32,43,0,1,76
21085,D103,0,13,13,0,1,27
21085,E101,1,18,21,0,3,43
21085,E102,1,56,53,0,1,111
21085,E103,1,5,3,0,0,9
21085,E104,0,18,12,0,2,32
21085,F101,0,27,32,0,4,63
21085,F103,2,40,42,0,6,90
21085,F105,0,14,11,0,4,29
21085,F106,1,15,9,0,0,25
21087,A101,1,32,36,0,2,71
21087,A102,1,20,26,0,2,49
21087,A103,3,42,51,0,4,100
21087,A104,1,27,30,0,1,59
21087,B101,2,54,33,1,10,100
21087,B102,3,35,21,0,7,66
21087,C101,1,42,21,0,6,70
21087,C102,1,38,23,1,1,64
21087,D101,0,22,11,0,3,36
21087,D102,1,38,22,1,4,66
21089,A101,3,53,43,0,4,103
21089,A102,2,76,68,1,12,159
21089,A103,2,102,87,1,8,200
21089,A104,1,50,37,0,9,97
21089,A105,0,39,40,0,0,79
21089,A106,3,43,65,0,0,111
21089,A107,1,31,31,0,2,65
21089,A108,2,59,56,0,5,122
21089,A109,0,77,80,0,14,171
21089,A110,1,71,54,2,20,148
21089,B101,3,45,34,1,10,93
21089,B102,0,67,48,0,4,119
21089,B103,2,63,50,0,6,121
21089,B104,2,46,29,0,8,85
21089,B105,3,54,20,1,6,84
21089,B107,1,45,43,0,5,94
21089,B108,2,76,72,0,13,163
21089,B110,4,33,23,0,4,64
21089,B111,2,80,49,0,9,140
21089,C101,3,23,64,0,6,96
21089,C102,1,45,38,0,13,97
21089,C103,0,36,34,1,5,76
21089,C104,4,74,51,0,9,138
21089,C105,0,57,61,1,6,125
21089,C106,3,59,51,0,10,123
21089,C107,0,54,64,2,9,129
21089,C108,1,44,67,0,7,119
21089,C109,3,57,37,2,10,109
21089,C110,1,53,58,0,5,117
21091,A101,4,50,59,1,10,124
21091,A102,2,87,77,0,8,174
21091,B101,4,63,56,1,5,129
21091,B102,1,53,40,1,12,107
21091,B103,2,33,32,0,9,76
21091,C101,2,89,80,1,9,181
21091,C102,0,58,64,0,9,131
21091,D101,1,31,27,0,3,62
21091,D102,1,59,21,0,2,83
21091,D103,0,35,21,0,2,58
21093,A001,0,29,44,0,5,78
21093,A002,2,56,87,0,12,157
21093,A003,0,35,44,0,2,81
21093,A004,0,48,129,0,8,185
21093,A005,3,52,75,0,4,134
21093,A006,2,63,136,0,9,210
21093,A007,0,10,20,0,1,31
21093,A008,3,78,82,1,4,168
21093,A009,0,10,14,2,0,26
21093,A010,0,15,12,0,0,27
21093,B001,1,46,47,0,9,103
21093,B002,1,71,146,1,4,223
21093,B003,2,85,148,0,7,242
21093,B004,1,73,126,0,7,207
21093,B005,0,60,49,0,5,114
21093,B006,0,59,111,1,9,180
21093,C001,0,67,68,0,6,141
21093,C002,1,97,101,0,4,203
21093,C003,3,89,53,1,12,158
21093,C004,4,112,122,2,14,254
21093,C005,2,80,45,1,6,134
21093,C006,2,94,98,1,5,200
21093,C007,0,85,69,0,7,161
21093,D001,3,68,82,1,9,163
21093,D002,3,85,111,1,10,210
21093,D003,2,71,99,2,5,179
21093,D004,1,119,136,0,5,261
21093,D005,4,96,116,0,8,224
21093,D006,2,41,51,0,5,99
21093,E001,2,67,68,0,6,143
21093,E002,2,66,63,0,4,135
21093,E003,2,138,112,0,14,266
21093,E004,1,94,122,0,6,223
21093,E005,0,85,92,0,9,186
21093,E006,0,50,37,0,2,89
21093,F001,4,86,75,1,13,179
21093,F002,3,92,41,1,7,144
21093,F003,6,120,84,0,18,228
21093,F004,5,100,98,1,6,210
21093,F005,2,92,57,1,6,158
21093,F006,7,111,51,1,10,180
21093,F007,3,51,40,1,9,104
21093,F008,0,5,6,0,0,11
21093,G001,0,40,31,1,6,78
21093,G002,2,66,34,1,7,110
21093,G003,3,37,28,1,5,74
21093,G004,1,60,24,1,6,92
21093,G005,0,11,5,0,0,16
21093,G006,2,119,72,1,11,205
21093,G007,4,72,47,1,4,128
21093,G008,2,81,36,1,7,127
21093,G009,1,62,63,0,7,133
21093,H001,2,89,76,0,4,171
21093,H002,4,14,19,0,2,39
21093,H003,0,10,2,0,0,12
21093,H004,3,86,59,1,9,158
21093,H005,1,95,135,0,9,240
21093,H006,5,63,96,1,10,175
21093,H007,2,89,89,0,12,192
21093,H008,1,74,46,0,2,123
21095,A101,4,71,49,0,14,138
21095,A108,6,92,25,0,13,136
21095,A110,1,29,16,0,0,46
21095,A111,1,22,4,1,0,28
21095,A112,0,22,11,0,0,33
21095,B102,1,47,14,0,12,74
21095,B103,0,29,6,0,2,37
21095,B104,2,42,11,0,7,62
21095,B105,1,26,14,0,8,49
21095,B106,1,46,14,1,4,66
21095,B107,1,17,5,0,0,23
21095,B109,0,9,7,0,2,18
21095,C101,0,19,2,0,3,24
21095,C102,0,14,5,2,1,22
21095,C103,0,11,9,0,0,20
21095,C104,1,19,17,2,2,41
21095,C106,0,12,4,1,2,19
21095,C107,2,22,7,0,1,32
21095,C109,1,41,21,1,5,69
21095,C111,0,29,41,0,2,72
21095,D101,1,81,24,1,10,117
21095,D103,2,12,10,0,3,27
21095,D104,1,45,17,1,5,69
21095,D106,3,48,15,0,3,69
21095,D108,1,10,4,0,1,16
21095,D109,2,16,2,1,1,22
21095,E102,4,73,27,4,6,114
21095,E104,3,51,7,1,4,66
21095,E105,1,30,11,0,4,46
21095,E106,0,39,13,1,4,57
21095,E107,4,31,10,0,8,53
21095,E108,3,18,8,0,4,33
21097,A101,5,60,76,0,7,148
21097,A102,1,36,46,2,6,91
21097,A103,0,9,16,0,0,25
21097,B101,2,78,66,0,9,155
21097,B102,3,32,42,2,5,84
21097,B103,0,6,11,0,0,17
21097,C101,5,59,55,1,6,126
21097,C102,4,74,58,0,13,149
21097,D101,5,69,52,1,8,135
21097,D102,6,80,48,1,7,142
21097,D103,2,19,31,0,2,54
21097,E101,2,68,47,0,10,127
21097,E102,3,63,44,1,6,117
21097,F101,0,68,47,1,7,123
21097,F102,2,63,51,0,7,123
21097,G101,0,57,35,2,5,99
21097,G102,2,48,26,1,7,84
21097,H101,2,77,41,0,10,130
21097,H102,3,68,43,0,8,122
21099,A101,1,34,31,0,4,70
21099,A102,0,74,89,1,11,175
21099,A103,1,17,23,0,2,43
21099,A104,4,68,54,3,8,137
21099,B102,2,55,52,0,4,113
21099,B103,2,61,68,0,5,136
21099,B104,4,53,42,0,9,108
21099,C101,3,78,43,0,6,130
21099,C102,3,114,72,1,18,208
21099,C103,2,57,52,2,6,119
21099,C104,4,25,22,0,8,59
21099,D101,1,46,33,0,2,82
21099,D102,3,32,11,0,3,49
21099,D103,5,36,16,1,4,62
21099,D104,2,92,27,4,10,135
21099,D105,0,15,28,0,4,47
21099,E102,0,31,21,0,1,53
21099,E103,3,85,64,0,5,157
21099,E104,2,54,27,0,9,92
21101,A101,1,65,48,0,11,125
21101,A102,0,45,40,1,11,97
21101,A108,2,64,67,1,14,148
21101,A110,2,81,55,0,13,151
21101,A111,1,73,67,3,21,165
21101,A112,1,66,75,0,11,153
21101,A114,4,106,96,0,32,238
21101,A116,1,69,97,0,16,183
21101,B101,2,76,38,0,18,134
21101,B102,2,28,21,1,7,59
21101,B103,2,65,54,2,21,144
21101,B104,4,62,40,0,34,140
21101,B105,4,81,47,0,26,158
21101,B106,0,74,94,0,26,194
21101,B108,3,59,70,1,19,152
21101,B109,0,38,19,0,10,67
21101,B110,0,82,82,1,29,194
21101,B111,1,94,74,0,30,199
21101,B112,0,22,20,0,10,52
21101,C101,4,68,49,0,19,140
21101,C102,1,31,30,0,6,68
21101,C103,2,41,44,0,8,95
21101,C104,1,73,58,1,31,164
21101,C105,1,54,36,0,19,110
21101,C106,2,41,22,0,13,78
21101,C107,4,100,76,0,16,196
21101,C109,4,54,52,0,10,120
21101,C110,3,37,35,0,14,89
21101,C111,2,47,39,0,13,101
21101,D101,3,61,94,0,18,176
21101,D102,1,24,83,0,4,112
21101,D103,1,53,54,0,10,118
21101,D104,2,43,93,0,5,143
21101,D106,6,77,82,0,3,168
21101,D109,1,48,57,0,17,123
21101,D111,3,120,122,1,30,276
21101,E105,0,89,118,1,29,237
21101,E106,0,45,52,0,26,123
21101,E107,0,68,65,1,18,152
21101,E108,0,67,70,0,17,154
21101,E109,2,54,63,0,14,133
21101,E110,3,54,60,1,21,139
21101,E111,1,41,61,0,11,114
21101,E112,4,52,60,1,22,139
21101,E113,2,83,92,1,27,205
21103,A101,4,69,68,1,11,153
21103,A102,3,42,55,1,6,107
21103,A103,1,23,25,0,3,52
21103,B101,0,76,63,1,8,148
21103,B102,1,24,12,0,4,41
21103,B103,1,25,38,0,8,72
21103,C101,5,93,81,0,17,196
21103,C102,1,42,15,0,6,64
21103,C103,1,38,26,0,1,66
21103,D101,4,110,101,1,16,232
21103,D102,1,49,50,1,9,110
21103,E101,0,24,11,0,2,37
21103,E102,3,32,25,1,5,66
21103,E103,0,31,21,0,3,55
21103,E104,1,33,15,1,5,55
21103,E105,2,23,11,1,1,38
21103,E106,0,49,33,1,5,88
21103,F101,2,39,38,2,6,87
21103,F102,0,31,23,0,3,57
21103,F103,3,84,61,0,12,160
21105,A101,3,32,32,2,10,79
21105,A102,0,51,55,0,24,130
21105,B101,1,57,36,1,19,114
21105,B102,0,55,27,0,18,100
21105,C101,4,53,31,1,16,105
21105,C102,2,47,25,0,29,103
21107,A001,3,38,36,0,4,81
21107,A002,4,53,30,0,14,101
21107,A003,3,100,40,0,16,159
21107,A004,2,13,3,0,4,22
21107,A005,3,28,15,1,10,57
21107,A006,0,50,45,0,16,111
21107,A007,2,95,21,0,11,129
21107,B008,2,54,58,2,15,131
21107,B009,4,59,29,0,12,104
21107,B010,3,38,12,1,11,65
21107,B011,3,48,34,0,13,98
21107,B012,1,45,32,1,7,86
21107,B013,0,34,13,0,8,55
21107,B014,1,54,37,0,9,101
21107,B015,2,41,40,0,12,95
21107,C016,3,85,45,1,18,152
21107,C017,2,81,38,0,15,136
21107,C018,1,98,29,1,15,144
21107,C019,0,51,37,3,17,108
21107,C020,1,27,21,0,15,64
21107,C021,2,73,41,1,16,133
21107,C022,1,41,68,0,5,115
21107,D023,4,84,43,0,20,151
21107,D024,6,65,41,1,19,132
21107,D025,2,52,53,1,10,118
21107,D026,3,25,11,0,8,47
21107,D027,4,118,98,1,23,244
21107,D028,4,52,43,2,18,119
21107,D029,2,15,13,0,3,33
21107,E030,1,59,20,0,17,97
21107,E031,2,66,18,1,9,96
21107,E032,0,34,13,0,4,51
21107,E033,8,81,43,0,22,154
21107,E034,1,94,53,2,24,174
21107,E035,1,48,45,0,5,99
21107,E036,2,31,14,1,11,59
21107,F037,5,22,11,0,10,48
21107,F038,3,68,41,0,13,125
21107,F039,1,51,39,0,16,107
21107,F040,4,44,25,2,9,84
21107,F041,2,31,5,1,4,43
21107,F042,4,51,24,0,11,90
21107,F043,3,82,57,0,17,159
21107,G044,0,33,12,0,13,58
21107,G045,4,50,28,0,10,92
21107,G046,2,38,27,0,9,76
21107,G047,4,37,26,1,10,78
21107,G048,2,45,40,0,9,96
21107,G049,3,46,40,2,14,105
21107,G050,0,19,14,0,5,38
21109,A101,0,5,2,0,0,7
21109,A102,0,9,5,0,0,14
21109,A103,0,6,2,0,1,9
21109,A104,0,4,0,0,0,4
21109,A105,0,0,1,1,0,2
21109,A106,0,2,1,0,1,4
21109,B101,0,18,11,0,0,29
21109,B102,2,32,15,0,1,50
21109,B103,0,16,12,0,1,29
21109,B104,0,7,6,0,0,13
21109,C101,0,10,7,0,1,18
21109,C102,0,2,1,0,0,3
21109,C103,1,8,6,0,1,16
21109,C104,0,5,0,0,1,6
21111,A105,3,126,205,3,6,343
21111,A107,1,53,87,0,5,146
21111,A108,1,87,143,0,11,242
21111,A111,3,71,100,0,3,177
21111,A113,0,87,120,0,4,211
21111,A114,5,71,65,0,8,149
21111,A115,2,64,91,0,8,165
21111,A118,1,51,35,0,2,89
21111,A119,1,79,62,0,3,145
21111,A121,0,72,90,0,6,168
21111,A123,1,115,118,0,3,237
21111,A124,3,81,97,0,6,187
21111,A125,2,92,103,0,7,204
21111,A126,1,64,109,3,3,180
21111,A127,2,60,60,0,2,124
21111,A128,2,48,73,0,4,127
21111,A129,3,93,96,0,5,197
21111,A130,1,43,40,0,5,89
21111,A131,0,96,104,0,4,204
21111,A134,0,48,44,0,3,95
21111,A135,1,73,75,0,2,151
21111,A136,0,60,62,0,1,123
21111,A139,0,47,61,0,3,111
21111,A140,1,105,117,0,8,231
21111,A141,1,5,2,0,0,8
21111,A142,1,20,25,0,1,47
21111,A143,0,0,0,0,0,0
21111,B124,1,64,87,0,7,159
21111,B132,0,64,97,2,7,170
21111,B133,0,99,130,1,9,239
21111,B134,2,104,158,0,8,272
21111,B149,0,49,46,0,3,98
21111,B151,2,91,138,1,6,238
21111,B153,0,3,6,0,0,9
21111,B154,0,73,82,1,5,161
21111,B155,1,72,84,0,3,160
21111,B156,2,123,114,0,4,243
21111,B157,4,137,181,0,5,327
21111,B158,1,72,127,0,3,203
21111,B159,2,136,166,0,10,314
21111,B160,0,55,71,0,3,129
21111,B161,1,10,9,0,0,20
21111,B162,0,82,97,0,7,186
21111,B163,1,101,130,1,4,237
21111,B166,2,68,80,0,4,154
21111,B168,2,101,112,1,1,217
21111,B169,1,54,84,0,2,141
21111,B170,1,52,84,0,1,138
21111,B172,2,107,162,1,4,276
21111,B173,0,94,84,1,6,185
21111,B175,1,64,118,0,5,188
21111,B177,1,52,104,0,1,158
21111,B181,0,15,16,0,1,32
21111,B182,0,41,63,0,9,113
21111,B183,3,97,164,0,4,268
21111,B184,0,0,0,0,0,0
21111,B185,0,37,30,0,2,69
21111,C101,3,74,261,0,3,341
21111,C102,1,74,126,1,1,203
21111,C103,0,74,127,0,4,205
21111,C104,1,51,96,0,1,149
21111,C105,2,36,128,0,0,166
21111,C106,2,143,257,1,6,409
21111,C108,2,106,228,0,6,342
21111,C109,0,30,100,0,1,131
21111,C110,0,52,212,0,0,264
21111,C111,1,107,352,0,1,461
21111,C113,0,20,67,0,1,88
21111,C115,2,112,196,0,1,311
21111,C122,0,80,71,0,5,156
21111,C123,0,42,57,0,1,100
21111,C124,2,123,111,0,4,240
21111,C125,0,83,116,0,0,199
21111,C126,0,117,131,0,0,248
21111,C128,0,26,33,0,1,60
21111,C129,3,161,176,2,7,349
21111,C130,0,8,12,0,1,21
21111,C131,2,45,44,1,0,92
21111,C133,2,97,227,0,4,330
21111,C134,0,100,95,1,6,202
21111,C135,0,68,107,0,6,181
21111,C136,1,44,71,0,4,120
21111,C137,3,83,103,0,7,196
21111,C138,1,73,79,1,2,156
21111,C139,0,0,2,0,0,2
21111,C141,1,50,83,0,2,136
21111,C142,0,84,111,2,3,200
21111,C143,0,15,11,0,0,26
21111,C144,2,11,12,0,0,25
21111,C145,0,22,16,0,0,38
21111,C146,0,0,0,0,0,0
21111,C147,0,1,3,0,0,4
21111,C148,0,2,11,0,0,13
21111,C149,0,1,0,0,0,1
21111,C150,0,0,0,0,0,0
21111,C151,0,4,5,0,0,9
21111,D101,0,58,71,0,1,130
21111,D104,2,91,101,0,2,196
21111,D106,4,93,105,0,1,203
21111,D108,2,122,128,0,1,253
21111,D109,0,53,54,0,3,110
21111,D110,0,70,112,0,4,186
21111,D113,0,50,119,0,0,169
21111,D114,3,95,113,0,2,213
21111,D115,2,117,142,0,6,267
21111,D116,1,133,145,0,4,283
21111,D117,1,73,129,0,2,205
21111,D120,1,140,145,0,5,291
21111,D121,0,70,82,0,3,155
21111,D122,2,77,86,0,3,168
21111,D126,7,122,148,2,2,281
21111,D129,1,56,71,0,4,132
21111,D130,1,101,100,1,3,206
21111,D131,3,62,80,0,2,147
21111,D132,1,139,289,0,10,439
21111,D135,1,81,82,0,0,164
21111,D136,1,109,204,0,9,323
21111,D137,1,66,69,1,3,140
21111,D138,2,112,201,1,7,323
21111,D139,2,88,152,1,5,248
21111,D140,1,78,144,0,5,228
21111,D141,1,56,100,0,4,161
21111,D142,0,75,111,1,1,188
21111,D144,2,45,56,0,3,106
21111,D145,3,44,101,0,3,151
21111,E139,0,81,68,0,2,151
21111,E141,3,47,36,0,3,89
21111,E142,0,71,109,0,7,187
21111,E143,0,75,78,0,0,153
21111,E144,1,131,90,0,3,225
21111,E145,0,99,84,0,4,187
21111,E148,2,101,200,1,18,322
21111,E152,1,75,134,0,3,213
21111,E154,0,82,126,0,7,215
21111,E155,0,109,102,1,1,213
21111,E157,0,29,28,0,0,57
21111,E158,0,58,92,0,2,152
21111,E159,0,53,69,0,1,123
21111,E160,4,60,102,0,3,169
21111,E161,2,20,49,0,6,77
21111,E162,1,12,27,0,1,41
21111,E163,1,67,90,1,2,161
21111,E164,1,61,100,0,6,168
21111,E165,1,75,136,0,4,216
21111,E166,0,66,74,0,4,144
21111,E167,2,84,95,0,3,184
21111,E168,2,40,52,0,0,94
21111,E169,3,109,163,1,8,284
21111,E171,1,82,83,0,3,169
21111,E173,1,76,61,0,2,140
21111,E175,0,61,77,0,0,138
21111,E176,0,40,43,0,2,85
21111,E177,1,31,41,0,2,75
21111,E178,0,50,111,0,0,161
21111,E179,1,40,112,0,1,154
21111,E180,1,64,114,0,0,179
21111,E181,1,82,143,0,4,230
21111,E182,0,116,200,1,3,320
21111,E183,2,75,102,0,3,182
21111,E184,1,49,79,0,4,133
21111,E185,0,38,25,0,5,68
21111,F106,0,59,90,1,1,151
21111,F145,1,79,149,0,2,231
21111,F151,1,109,155,1,4,270
21111,F152,3,89,129,0,7,228
21111,F153,2,97,127,0,4,230
21111,F154,2,57,110,0,0,169
21111,F155,1,22,43,0,0,66
21111,F156,1,111,119,0,5,236
21111,F158,0,21,31,0,0,52
21111,F161,1,51,81,0,4,137
21111,F163,2,38,115,0,3,158
21111,F164,0,55,102,0,3,160
21111,F166,2,64,78,0,5,149
21111,F167,2,65,101,0,1,169
21111,F169,0,34,61,0,0,95
21111,F170,0,44,69,0,1,114
21111,F171,1,57,77,1,3,139
21111,F172,0,75,83,0,4,162
21111,F176,1,65,95,0,4,165
21111,F179,0,104,93,0,4,201
21111,F180,2,111,139,0,2,254
21111,F181,1,112,204,0,3,320
21111,F182,3,159,145,0,5,312
21111,F183,2,22,30,0,1,55
21111,F184,0,46,91,0,1,138
21111,F185,1,94,133,0,3,231
21111,F186,2,143,218,0,6,369
21111,F187,0,74,117,0,4,195
21111,G103,0,154,107,2,1,264
21111,G104,0,132,89,0,1,222
21111,G106,0,123,140,0,1,264
21111,G107,0,133,156,0,0,289
21111,G108,0,97,128,0,2,227
21111,G109,3,153,237,0,4,397
21111,G111,0,189,168,0,5,362
21111,G112,2,297,263,0,9,571
21111,G116,3,242,219,2,4,470
21111,G117,0,234,308,0,11,553
21111,G119,1,110,146,2,7,266
21111,G120,0,126,149,0,6,281
21111,G121,2,118,155,1,12,288
21111,G122,1,101,126,0,6,234
21111,G123,0,39,76,0,4,119
21111,G124,6,180,205,6,10,407
21111,G126,3,124,127,0,3,257
21111,G129,2,39,37,0,2,80
21111,G140,0,144,146,0,0,290
21111,G141,1,130,149,0,2,282
21111,G142,0,34,32,0,0,66
21111,G143,1,181,252,0,3,437
21111,G144,0,157,196,0,4,357
21111,G145,3,202,266,0,10,481
21111,G146,2,220,200,0,11,433
21111,G147,1,142,194,0,9,346
21111,G148,0,69,73,0,4,146
21111,G149,0,65,96,1,1,163
21111,G150,1,70,54,0,1,126
21111,G151,0,82,76,0,7,165
21111,G154,2,124,96,0,6,228
21111,G155,1,111,124,0,3,239
21111,G156,2,69,109,1,5,186
21111,G157,1,142,150,0,4,297
21111,G158,2,102,136,1,4,245
21111,G159,0,0,0,0,0,0
21111,G160,1,45,73,1,1,121
21111,G161,0,93,136,0,5,234
21111,G162,0,12,20,0,2,34
21111,G163,1,74,73,0,2,150
21111,G164,0,132,172,0,3,307
21111,G165,0,46,72,0,4,122
21111,G166,0,29,25,1,0,55
21111,G167,0,62,46,0,2,110
21111,G168,0,9,9,0,1,19
21111,G169,0,41,74,0,1,116
21111,H102,1,219,92,0,1,313
21111,H103,2,204,225,0,5,436
21111,H105,1,214,95,0,2,312
21111,H106,0,157,121,0,5,283
21111,H109,1,73,46,2,3,125
21111,H110,0,161,126,0,4,291
21111,H111,0,78,69,0,1,148
21111,H112,3,96,125,0,7,231
21111,H113,1,63,71,0,2,137
21111,H114,0,2,0,0,0,2
21111,H115,1,81,67,1,4,154
21111,H116,2,108,88,0,6,204
21111,H117,1,153,152,1,12,319
21111,H118,1,121,104,0,7,233
21111,H120,8,185,123,1,3,320
21111,H121,3,64,47,0,3,117
21111,H123,0,32,35,0,2,69
21111,H124,0,21,23,0,0,44
21111,H125,1,28,59,0,8,96
21111,H126,0,65,62,1,5,133
21111,H127,1,35,54,0,1,91
21111,H130,0,0,0,0,0,0
21111,H131,0,121,57,0,3,181
21111,H132,0,71,58,0,0,129
21111,H133,0,29,13,0,1,43
21111,H138,0,144,165,0,8,317
21111,H141,0,154,123,0,2,279
21111,H144,3,95,78,0,5,181
21111,H145,1,54,64,1,2,122
21111,H146,1,83,87,0,2,173
21111,H147,1,77,64,0,7,149
21111,H148,0,72,68,1,3,144
21111,H150,0,0,0,0,0,0
21111,H151,0,0,0,0,0,0
21111,H152,0,30,21,0,2,53
21111,H153,0,0,0,0,0,0
21111,H154,0,21,25,0,0,46
21111,H155,0,22,30,0,1,53
21111,H156,0,0,0,0,0,0
21111,H157,0,9,8,0,0,17
21111,H158,0,0,0,0,0,0
21111,H159,1,20,14,0,4,39
21111,H160,0,109,110,0,3,222
21111,H161,0,0,1,0,0,1
21111,H162,0,60,59,0,5,124
21111,I107,3,136,82,0,2,223
21111,I109,0,75,56,0,1,132
21111,I110,0,39,27,0,4,70
21111,I111,2,178,164,1,9,354
21111,I112,0,142,100,0,5,247
21111,I115,0,54,55,1,1,111
21111,I120,0,47,55,0,5,107
21111,I122,2,40,40,0,4,86
21111,I123,1,132,145,0,5,283
21111,I124,0,49,51,0,2,102
21111,I125,1,34,37,0,1,73
21111,I126,2,63,63,0,9,137
21111,I130,0,37,29,0,1,67
21111,I133,3,107,100,0,15,225
21111,I135,2,52,34,0,1,89
21111,I138,0,0,0,0,0,0
21111,I140,0,12,20,0,0,32
21111,I141,1,71,64,0,3,139
21111,I142,0,0,0,0,0,0
21111,I143,0,12,5,0,2,19
21111,I144,0,10,9,0,0,19
21111,I145,0,15,13,0,1,29
21111,I146,2,56,63,2,2,125
21111,I147,0,1,6,0,0,7
21111,I148,0,28,35,1,2,66
21111,I149,0,0,0,0,0,0
21111,I150,0,11,5,0,0,16
21111,I151,1,79,91,0,2,173
21111,I152,3,98,89,0,7,197
21111,I153,1,134,124,0,11,270
21111,I154,4,94,139,2,3,242
21111,I155,0,4,5,0,0,9
21111,I156,0,40,37,0,4,81
21111,J101,2,95,141,1,6,245
21111,J104,1,99,163,0,3,266
21111,J105,0,54,80,0,1,135
21111,J107,1,48,79,1,3,132
21111,J108,1,173,114,1,6,295
21111,J111,0,94,95,0,2,191
21111,J113,6,131,108,1,8,254
21111,J114,3,128,134,1,10,276
21111,J117,0,50,79,1,6,136
21111,J119,1,91,86,0,4,182
21111,J120,2,89,112,0,3,206
21111,J122,1,57,79,0,3,140
21111,J123,1,50,49,1,4,105
21111,J130,0,43,40,0,2,85
21111,J135,2,68,79,0,3,152
21111,J137,0,73,62,0,1,136
21111,J138,0,13,13,0,1,27
21111,J140,1,20,36,0,1,58
21111,J141,2,48,39,1,2,92
21111,J142,0,1,2,0,0,3
21111,J143,0,11,11,0,0,22
21111,J144,1,67,93,1,7,169
21111,J145,4,72,91,1,6,174
21111,J146,0,0,0,0,0,0
21111,J147,0,110,118,0,1,229
21111,J148,2,111,100,1,7,221
21111,J149,0,100,108,0,7,215
21111,J150,1,62,60,0,1,124
21111,J151,0,2,2,0,0,4
21111,J152,4,58,53,1,5,121
21111,J153,0,24,23,0,0,47
21111,J154,0,0,0,0,0,0
21111,J155,0,25,19,0,2,46
21111,K104,0,86,26,0,1,113
21111,K105,0,249,75,1,0,325
21111,K110,0,65,89,1,1,156
21111,K111,0,51,60,0,0,111
21111,K112,0,66,67,0,0,133
21111,K113,0,38,56,0,2,96
21111,K114,0,89,115,0,1,205
21111,K116,0,14,23,0,0,37
21111,K117,0,102,88,0,2,192
21111,K118,2,57,186,0,1,246
21111,K119,0,91,111,0,1,203
21111,K122,0,84,198,1,6,289
21111,K123,0,93,280,1,6,380
21111,K125,1,27,47,0,2,77
21111,K126,1,45,62,0,2,110
21111,K127,4,84,133,0,8,229
21111,K128,2,59,88,1,4,154
21111,K129,0,175,87,0,5,267
21111,K130,1,62,165,1,2,231
21111,K131,1,63,119,0,4,187
21111,K132,0,19,32,0,0,51
21111,K133,3,137,82,0,1,223
21111,K134,1,101,64,2,3,171
21111,K135,0,2,3,0,0,5
21111,K136,2,13,26,0,0,41
21111,K137,0,23,38,0,0,61
21111,K138,0,23,16,0,2,41
21111,K139,0,0,0,0,0,0
21111,K140,0,36,45,0,0,81
21111,K141,0,32,35,0,1,68
21111,K142,0,0,0,0,0,0
21111,K143,0,0,0,0,0,0
21111,K144,1,62,117,0,6,186
21111,K145,4,125,158,0,6,293
21111,K146,2,91,104,0,2,199
21111,K147,0,105,150,0,6,261
21111,K148,1,70,88,0,2,161
21111,K149,0,0,1,0,0,1
21111,K150,0,0,0,0,0,0
21111,K151,0,0,0,0,0,0
21111,L104,1,90,226,0,2,319
21111,L108,1,30,160,0,1,192
21111,L110,0,1,10,0,0,11
21111,L111,0,64,58,0,1,123
21111,L112,1,48,109,0,3,161
21111,L113,1,145,182,0,3,331
21111,L115,2,35,14,0,1,52
21111,L117,1,120,130,0,1,252
21111,L118,4,174,219,0,13,410
21111,L119,0,126,107,0,1,234
21111,L134,0,64,108,0,3,175
21111,L135,0,62,93,1,1,157
21111,L136,0,130,145,0,1,276
21111,L138,2,76,84,1,2,165
21111,L139,1,125,163,0,6,295
21111,L140,0,34,94,0,0,128
21111,L141,0,74,78,0,0,152
21111,L142,0,50,124,0,3,177
21111,L143,0,70,64,0,3,137
21111,L144,1,22,101,0,0,124
21111,L145,0,46,171,0,1,218
21111,L146,2,111,129,0,7,249
21111,L147,0,43,182,0,0,225
21111,L148,0,32,82,0,0,114
21111,L149,0,8,3,0,1,12
21111,L150,0,6,27,0,0,33
21111,L151,0,66,84,2,3,155
21111,L152,0,39,48,0,1,88
21111,L153,1,10,8,1,0,20
21111,L154,0,53,132,0,0,185
21111,L155,0,4,2,0,0,6
21111,L156,1,116,177,1,1,296
21111,L157,1,47,218,0,1,267
21111,L158,0,27,116,0,0,143
21111,L159,0,10,69,0,0,79
21111,L160,0,24,108,0,0,132
21111,L161,0,43,192,0,2,237
21111,L162,0,1,1,0,0,2
21111,L163,1,13,137,0,1,152
21111,L164,0,80,38,0,2,120
21111,M102,1,143,398,0,3,545
21111,M103,2,129,448,0,2,581
21111,M104,0,55,145,1,0,201
21111,M105,1,42,164,1,0,208
21111,M107,0,25,81,1,0,107
21111,M110,1,69,249,0,3,322
21111,M121,1,158,157,0,1,317
21111,M123,2,219,196,0,4,421
21111,M124,0,221,135,0,2,358
21111,M129,0,28,91,0,0,119
21111,M130,0,19,94,0,0,113
21111,M131,0,92,80,0,2,174
21111,M133,1,86,293,0,1,381
21111,M137,0,119,85,0,1,205
21111,M138,1,198,230,1,1,431
21111,M139,0,200,87,0,4,291
21111,M140,0,59,41,0,2,102
21111,M141,0,105,83,0,1,189
21111,M142,1,310,208,1,1,521
21111,M143,1,132,101,0,2,236
21111,M144,1,109,33,1,0,144
21111,M145,0,20,17,0,2,39
21111,M146,0,107,143,0,1,251
21111,M147,0,134,47,0,0,181
21111,M148,1,42,228,0,1,272
21111,M149,0,46,105,0,3,154
21111,M150,0,70,64,0,2,136
21111,M159,0,31,12,0,0,43
21111,M160,0,27,22,0,0,49
21111,M162,2,75,55,0,2,134
21111,M163,2,55,49,0,0,106
21111,M164,0,7,4,0,0,11
21111,M165,0,0,0,0,0,0
21111,M166,0,66,104,0,0,170
21111,M167,0,0,0,0,0,0
21111,M168,0,47,17,0,0,64
21111,M169,2,64,190,0,0,256
21111,M170,0,88,288,0,0,376
21111,M171,4,69,292,0,0,365
21111,M172,0,27,31,0,1,59
21111,M173,1,55,297,1,2,356
21111,M174,0,0,0,0,0,0
21111,M175,0,0,0,0,0,0
21111,N101,2,88,264,0,2,356
21111,N102,0,70,92,0,2,164
21111,N103,1,111,344,0,2,458
21111,N104,2,76,351,0,0,429
21111,N105,1,52,219,0,1,273
21111,N106,0,99,292,1,2,394
21111,N107,1,69,295,1,2,368
21111,N108,1,88,313,0,5,407
21111,N109,0,61,220,1,1,283
21111,N110,1,43,198,0,2,244
21111,N111,0,38,142,0,0,180
21111,N112,0,44,165,0,2,211
21111,N113,2,23,116,0,2,143
21111,N115,0,54,71,1,2,128
21111,N117,0,58,140,0,0,198
21111,N124,0,0,0,0,0,0
21111,N125,0,76,114,0,3,193
21111,N126,0,41,76,0,5,122
21111,N127,0,6,21,0,0,27
21111,N128,1,28,49,0,0,78
21111,N130,0,122,178,1,3,304
21111,N131,3,61,100,0,1,165
21111,N134,3,130,186,0,3,322
21111,N135,0,14,16,0,0,30
21111,N136,2,47,69,0,1,119
21111,N137,0,20,60,0,0,80
21111,N138,0,7,41,0,1,49
21111,N139,1,9,35,0,1,46
21111,N141,0,51,81,0,5,137
21111,N142,0,78,163,0,5,246
21111,N143,0,128,157,0,7,292
21111,N144,0,73,84,1,4,162
21111,N145,2,40,177,0,0,219
21111,N146,1,72,97,0,3,173
21111,N147,1,10,30,0,0,41
21111,N148,2,49,91,0,0,142
21111,N149,0,6,58,0,0,64
21111,N150,0,2,18,0,0,20
21111,O105,1,91,246,0,2,340
21111,O107,2,143,292,0,1,438
21111,O109,0,110,256,1,2,369
21111,O111,0,71,167,0,4,242
21111,O112,1,62,82,0,1,146
21111,O113,0,61,147,0,3,211
21111,O114,0,73,103,0,2,178
21111,O115,0,102,120,0,8,230
21111,O117,0,86,248,0,2,336
21111,O119,5,107,275,1,5,393
21111,O121,2,87,186,0,3,278
21111,O123,0,44,101,0,2,147
21111,O124,5,54,107,1,6,173
21111,O126,3,78,151,0,7,239
21111,O127,3,89,97,0,2,191
21111,O128,3,103,152,1,6,265
21111,O129,3,98,135,1,8,245
21111,O130,2,62,109,0,5,178
21111,O131,4,64,79,0,2,149
21111,O133,0,82,104,0,2,188
21111,O134,1,73,96,0,6,176
21111,O135,3,78,101,0,5,187
21111,O136,0,69,68,0,6,143
21111,O137,3,90,211,0,9,313
21111,O138,1,32,45,0,0,78
21111,O139,0,9,1,0,0,10
21111,O141,0,0,0,0,0,0
21111,O142,1,56,55,3,4,119
21111,O143,0,3,4,0,0,7
21111,Q101,3,131,166,0,6,306
21111,Q103,3,128,189,0,7,327
21111,Q104,0,36,31,0,3,70
21111,Q105,2,134,206,0,7,349
21111,Q107,2,120,207,0,2,331
21111,Q109,2,115,138,1,6,262
21111,Q112,2,83,129,0,5,219
21111,Q113,1,51,39,0,1,92
21111,Q114,1,85,76,0,2,164
21111,Q115,2,108,125,0,7,242
21111,Q116,5,99,125,0,8,237
21111,Q117,5,54,98,2,10,169
21111,Q119,1,106,94,0,12,213
21111,Q122,1,83,209,0,2,295
21111,Q123,1,79,286,1,1,368
21111,Q124,0,74,156,0,0,230
21111,Q125,4,146,150,0,7,307
21111,Q126,1,52,55,0,5,113
21111,Q127,0,65,88,0,0,153
21111,Q131,0,46,56,0,3,105
21111,Q132,3,54,67,0,3,127
21111,Q134,1,66,93,0,6,166
21111,Q136,1,28,34,0,3,66
21111,Q137,0,81,100,0,3,184
21111,Q138,1,72,59,1,0,133
21111,Q139,0,37,43,0,7,87
21111,S116,1,50,118,1,3,173
21111,S118,3,78,157,0,7,245
21111,S119,3,123,237,0,3,366
21111,S125,0,76,212,1,4,293
21111,S126,1,74,99,1,4,179
21111,S128,3,66,113,0,1,183
21111,S129,0,57,87,0,1,145
21111,S130,3,89,106,0,3,201
21111,S131,0,111,139,0,2,252
21111,S132,1,86,162,0,5,254
21111,S135,2,108,147,0,1,258
21111,S139,1,120,184,1,4,310
21111,S140,0,67,92,1,8,168
21111,S141,1,116,182,2,4,305
21111,S142,2,78,98,0,2,180
21111,S143,0,53,102,0,4,159
21111,S144,0,43,129,0,2,174
21111,S146,0,80,94,0,3,177
21111,S150,4,59,129,0,5,197
21111,S152,1,49,101,0,1,152
21111,S153,2,46,123,0,2,173
21111,S156,0,71,123,0,0,194
21111,S160,1,95,213,0,6,315
21111,S161,0,71,92,0,1,164
21111,S164,0,59,101,0,1,161
21111,S165,4,37,93,0,1,135
21111,S166,0,53,97,0,1,151
21111,S167,1,51,91,1,2,146
21111,S168,2,43,62,0,0,107
21111,V101,1,88,85,0,7,181
21111,V102,1,84,141,0,4,230
21111,V103,1,46,36,1,0,84
21111,V104,3,63,153,1,2,222
21111,V105,3,79,105,0,3,190
21111,V106,0,70,74,0,5,149
21111,V107,0,39,44,0,7,90
21111,V108,1,61,79,0,4,145
21111,V109,0,1,10,0,0,11
21111,V110,1,73,119,0,6,199
21111,V111,0,50,104,0,4,158
21111,V112,0,2,2,0,0,4
21111,V113,2,89,166,1,7,265
21111,V114,0,42,59,0,3,104
21111,V115,4,76,91,0,6,177
21111,V116,2,70,115,0,5,192
21111,V117,0,66,88,0,4,158
21111,V118,0,101,98,0,6,205
21111,V119,1,86,132,0,2,221
21111,V120,1,102,106,0,3,212
21111,V121,1,82,119,0,3,205
21111,V122,0,0,0,0,0,0
21111,V123,0,0,0,0,0,0
21111,V124,0,42,86,0,4,132
21111,V125,0,45,77,0,1,123
21111,V126,1,74,95,0,2,172
21111,V127,3,84,137,0,2,226
21111,V128,0,60,99,2,3,164
21111,V129,0,47,99,0,6,152
21111,V130,0,20,31,0,3,54
21111,V131,0,48,89,0,0,137
21111,V132,0,41,54,0,3,98
21113,A101,0,29,26,0,3,58
21113,A102,2,42,44,0,2,90
21113,A103,0,82,70,0,4,156
21113,A104,1,63,46,1,5,116
21113,A105,0,74,70,0,5,149
21113,A106,0,64,66,0,5,135
21113,A107,2,39,35,1,3,80
21113,B101,3,79,59,0,4,145
21113,B102,1,73,68,0,7,149
21113,B103,2,39,54,0,2,97
21113,B104,1,57,53,0,7,118
21113,B105,2,69,65,1,14,151
21113,C101,3,86,55,0,7,151
21113,C102,4,77,41,1,10,133
21113,C103,0,83,85,0,5,173
21113,C104,1,70,59,0,6,136
21113,C105,0,94,85,0,7,186
21113,D101,1,12,24,0,2,39
21113,D102,1,43,50,0,0,94
21113,D103,1,79,45,1,12,138
21113,D104,2,51,50,1,2,106
21113,D105,1,39,27,0,4,71
21113,D106,2,45,20,0,3,70
21113,D107,1,34,29,0,5,69
21113,E101,0,17,14,0,0,31
21113,E102,4,54,72,0,3,133
21113,E103,0,39,27,0,4,70
21113,E104,1,52,43,0,3,99
21113,E105,1,39,52,0,5,97
21113,E106,2,62,70,0,7,141
21113,E107,2,29,23,0,2,56
21113,F101,2,62,50,2,5,121
21113,F102,1,67,52,1,12,133
21113,F103,4,81,64,1,3,153
21113,F104,4,47,43,0,5,99
21113,F105,0,75,70,1,3,149
21115,A101,1,26,21,0,2,50
21115,A102,3,25,11,1,1,41
21115,A103,0,14,9,0,1,24
21115,A104,2,20,9,0,3,34
21115,A105,0,44,28,1,4,77
21115,A106,1,37,25,1,3,67
21115,A107,0,21,17,0,2,40
21115,A108,1,45,35,1,5,87
21115,A109,0,5,2,0,1,8
21115,A110,1,18,7,0,3,29
21115,B101,1,26,17,0,11,55
21115,B102,4,27,10,0,2,43
21115,B103,1,31,20,0,4,56
21115,B104,2,22,11,0,4,39
21115,B105,1,38,15,0,3,57
21115,B106,1,21,15,1,8,46
21115,B107,2,29,25,0,5,61
21115,B108,0,4,6,0,0,10
21115,B109,1,34,12,1,11,59
21115,B110,0,19,14,0,4,37
21115,C101,0,14,9,0,0,23
21115,C102,1,25,11,0,0,37
21115,C103,3,44,16,1,10,74
21115,C104,2,24,9,1,2,38
21115,C105,0,11,12,0,2,25
21115,C106,0,20,16,0,5,41
21115,C107,1,30,7,1,0,39
21115,C108,0,11,6,0,0,17
21115,C109,0,19,7,1,4,31
21115,C110,0,7,10,0,2,19
21115,C111,0,9,8,0,3,20
21119,A101,2,59,25,0,9,95
21119,A103,2,41,35,0,1,79
21119,A104,7,85,44,1,11,148
21119,A105,0,46,25,0,2,73
21119,A106,1,37,17,0,4,59
21119,A108,2,33,20,1,3,59
21119,B101,3,51,19,0,13,86
21119,B102,1,50,37,1,4,93
21119,B103,0,28,8,1,7,44
21119,B104,1,50,11,1,6,69
21119,B105,0,23,21,1,7,52
21119,B106,1,15,7,0,1,24
21119,B107,2,51,24,0,1,78
21119,C101,0,38,22,0,3,63
21119,C102,1,53,25,1,9,89
21119,C103,0,8,7,0,1,16
21119,C104,0,7,4,1,0,12
21119,C105,2,31,7,1,0,41
21119,C106,2,3,0,1,1,7
21119,C107,2,30,21,0,7,60
21119,C108,1,47,17,0,1,66
21119,C109,1,19,11,1,3,35
21119,C110,3,23,8,0,1,35
21119,C111,0,16,7,0,2,25
21119,C112,0,30,37,2,5,74
21119,D102,2,15,9,0,3,29
21119,D103,3,43,21,1,7,75
21119,D104,2,43,23,1,5,74
21119,D105,0,62,41,1,10,114
21119,D107,0,49,18,0,3,70
21121,A101,0,5,6,0,1,12
21121,A102,0,8,9,0,1,18
21121,A103,0,6,4,0,1,11
21121,A104,2,24,25,1,3,55
21121,A105,0,30,35,0,4,69
21121,A106,2,14,25,0,3,44
21121,B101,0,6,1,0,0,7
21121,B102,0,3,6,0,0,9
21121,B103,0,1,2,0,1,4
21121,B104,0,4,6,0,0,10
21121,B105,1,6,8,0,2,17
21121,B106,0,2,6,0,0,8
21121,B107,0,5,12,0,0,17
21121,B108,2,13,16,0,0,31
21121,C101,0,12,14,0,1,27
21121,C102,0,18,8,0,0,26
21121,C103,0,43,49,0,3,95
21121,C104,1,21,18,1,3,44
21121,C105,1,9,12,0,0,22
21121,D101,1,27,23,0,1,52
21121,D102,0,17,16,0,0,33
21121,D103,0,15,25,1,3,44
21121,D104,1,32,33,0,0,66
21121,D105,1,28,32,0,1,62
21121,E101,0,15,15,0,1,31
21121,E102,0,1,2,0,1,4
21121,E103,0,22,15,0,2,39
21121,E104,0,25,14,0,2,41
21121,E105,1,49,33,0,4,87
21121,E106,2,34,25,1,2,64
21123,A101,6,130,83,2,33,254
21123,A103,3,66,65,2,11,147
21123,B101,5,105,99,0,13,222
21123,B102,0,54,48,0,12,114
21123,B103,2,51,40,0,13,106
21123,C101,4,135,76,5,25,245
21123,C102,3,61,41,1,17,123
21123,C103,2,31,16,0,5,54
21123,D101,5,100,54,1,30,190
21123,D102,3,86,22,1,13,125
21123,D103,2,37,18,0,2,59
21123,D104,1,32,14,0,10,57
21125,A101,0,13,15,0,0,28
21125,A102,1,11,13,0,0,25
21125,A103,1,31,27,0,1,60
21125,A104,0,11,15,0,4,30
21125,A105,0,23,13,0,0,36
21125,A106,1,31,24,0,1,57
21125,A107,0,21,25,0,2,48
21125,A108,0,26,29,0,0,55
21125,B101,1,16,22,0,2,41
21125,B102,0,21,22,0,1,44
21125,B103,1,39,34,0,3,77
21125,B104,0,16,16,0,0,32
21125,B105,0,26,25,1,3,55
21125,B106,0,25,15,0,5,45
21125,C101,1,5,10,0,0,16
21125,C102,0,7,6,0,1,14
21125,C103,0,4,1,0,0,5
21125,C104,0,34,25,0,1,60
21125,C105,0,6,17,0,2,25
21125,C106,0,11,8,0,3,22
21125,C108,0,11,12,0,2,25
21125,C109,0,20,22,0,1,43
21125,C110,0,13,21,0,0,34
21125,D101,0,19,32,0,4,55
21125,D102,0,2,22,1,2,27
21125,D103,0,6,5,0,1,12
21125,D104,1,10,7,0,3,21
21125,D105,0,7,9,0,1,17
21125,D106,0,13,11,0,0,24
21125,D107,0,11,24,0,3,38
21125,D108,0,12,8,0,0,20
21125,E101,0,10,24,0,1,35
21125,E103,0,18,16,0,0,34
21125,E104,0,27,25,0,0,52
21125,E105,0,17,18,0,0,35
21125,E106,0,24,21,0,2,47
21125,E107,0,7,2,0,2,11
21125,E108,1,5,16,0,2,24
21125,F101,1,24,18,0,0,43
21125,F102,1,28,16,0,2,47
21125,F103,0,9,15,0,1,25
21125,F104,0,32,26,0,4,62
21125,F105,0,28,23,0,2,53
21125,F106,0,12,11,0,0,23
21125,F107,0,24,28,0,3,55
21131,A101,0,2,1,0,0,3
21131,A102,1,7,3,0,1,12
21131,A103,0,0,0,0,0,0
21131,A104,0,11,4,0,0,15
21131,A105,0,0,2,0,0,2
21131,B101,0,7,2,0,0,9
21131,B102,0,10,9,0,1,20
21131,B103,0,3,0,0,0,3
21131,B104,0,2,1,0,1,4
21131,C101,0,5,4,0,0,9
21131,C102,0,5,7,0,0,12
21131,C103,0,9,4,0,0,13
21131,D101,0,6,5,0,1,12
21131,D102,0,1,9,0,0,10
21131,D103,0,3,5,0,0,8
21131,D104,0,3,4,0,0,7
21131,D105,0,1,0,0,0,1
21133,A101,2,81,44,1,14,142
21133,A102,1,91,52,1,19,164
21133,A103,0,96,23,2,23,144
21133,A104,5,22,12,1,6,46
21133,A105,1,17,8,0,6,32
21133,A106,4,52,17,1,6,80
21133,A107,1,32,10,0,12,55
21133,A108,4,33,13,1,7,58
21133,B101,3,122,39,0,21,185
21133,B102,3,108,31,1,14,157
21133,B103,3,74,25,1,24,127
21133,C101,2,45,25,0,12,84
21133,C102,2,44,16,0,11,73
21133,C103,7,114,51,1,28,201
21133,C104,2,34,22,0,18,76
21133,C105,3,63,28,0,7,101
21133,C106,1,43,15,2,6,67
21133,C107,1,67,39,1,16,124
21133,D102,3,97,54,0,23,177
21133,D103,2,46,23,0,10,81
21133,D104,4,51,22,3,7,87
21133,D105,3,43,14,0,23,83
21133,D106,1,52,28,0,5,86
21133,D107,4,91,23,3,19,140
21133,E101,0,38,29,0,11,78
21133,E102,3,17,24,2,5,51
21133,E103,2,47,40,3,18,110
21133,E104,0,31,15,0,6,52
21133,E105,3,75,30,0,19,127
21133,E106,1,15,16,0,7,39
21137,A101,1,42,58,2,5,108
21137,A102,3,83,87,0,9,182
21137,A103,2,51,78,0,1,132
21137,A104,3,14,33,0,3,53
21137,B101,1,41,50,0,3,95
21137,B102,1,38,33,1,3,76
21137,B103,1,21,28,0,4,54
21137,B104,1,75,54,0,12,142
21137,C101,2,21,20,1,6,50
21137,C102,0,63,35,0,7,105
21137,C103,1,34,35,2,2,74
21137,C104,1,76,58,0,6,141
21137,D101,2,27,36,0,5,70
21137,D102,0,34,37,0,1,72
21137,D103,1,69,75,0,5,150
21137,D105,0,21,24,1,4,50
21137,D106,0,21,18,0,1,40
21139,A101,2,141,78,2,26,249
21139,B101,2,38,25,1,15,81
21139,B102,3,78,55,0,16,152
21139,B103,0,60,53,1,14,128
21139,C101,1,21,17,1,8,48
21139,C102,3,65,39,1,10,118
21139,C103,2,26,8,0,4,40
21139,D101,2,65,42,1,12,122
21139,D102,0,63,35,1,15,114
21139,D103,2,42,39,1,7,91
21141,A101,1,45,55,0,11,112
21141,A104,7,99,63,0,10,179
21141,A105,3,48,50,0,11,112
21141,B101,0,38,43,1,10,92
21141,B102,1,46,45,0,5,97
21141,B103,3,54,59,2,14,132
21141,B104,4,53,64,0,7,128
21141,C101,3,46,50,0,11,110
21141,C102,3,40,42,0,6,91
21141,C103,0,51,38,1,4,94
21141,C104,1,37,24,0,12,74
21141,D101,2,58,40,0,9,109
21141,D102,3,97,57,0,14,171
21141,D103,0,34,20,1,4,59
21141,E101,0,36,31,2,9,78
21141,E102,4,80,98,0,16,198
21141,E103,2,63,35,0,12,112
21141,F101,0,48,80,0,2,130
21141,F102,10,87,72,1,12,182
21141,F103,2,56,87,1,8,154
21143,A101,5,83,58,0,22,168
21143,A102,4,87,83,0,16,190
21143,B101,3,78,83,2,24,190
21143,B102,6,111,80,1,31,229
21143,C101,1,89,87,3,21,201
21143,C102,3,100,91,1,20,215
21151,A101,1,85,34,0,9,129
21151,A102,3,148,109,0,3,263
21151,A103,1,148,43,0,1,193
21151,A104,2,107,99,0,16,224
21151,A105,1,113,88,1,6,209
21151,A106,1,181,105,0,9,296
21151,A107,3,98,68,0,9,178
21151,A108,1,89,48,0,6,144
21151,A109,2,138,66,1,23,230
21151,A110,0,49,41,1,7,98
21151,B101,2,179,94,1,8,284
21151,B102,2,68,80,0,5,155
21151,B103,1,137,111,1,6,256
21151,B104,1,72,49,0,5,127
21151,B105,2,182,224,3,13,424
21151,B106,2,60,52,0,2,116
21151,B107,0,181,74,2,3,260
21151,B108,0,57,26,0,4,87
21151,B109,4,92,71,1,6,174
21151,B110,2,126,150,0,8,286
21151,C101,0,2,0,0,0,2
21151,C102,1,51,37,1,11,101
21151,C103,2,119,85,2,19,227
21151,C104,4,44,35,0,4,87
21151,C105,2,70,54,0,7,133
21151,C106,4,67,49,0,8,128
21151,C107,6,93,89,1,12,201
21151,C108,1,21,26,1,2,51
21151,C109,3,87,86,0,6,182
21151,C110,1,118,145,1,7,272
21151,C112,1,184,109,1,9,304
21151,C113,1,82,76,0,4,163
21151,C114,0,47,53,0,3,103
21151,D101,2,51,40,0,4,97
21151,D102,3,90,57,0,12,162
21151,D103,2,94,61,0,12,169
21151,D104,0,6,21,0,1,28
21151,D105,2,84,49,0,12,147
21151,D106,7,152,110,0,11,280
21151,D107,0,0,2,0,0,2
21151,D109,4,120,123,1,7,255
21151,D110,0,79,31,0,0,110
21151,D111,0,116,134,1,8,259
21151,D112,2,79,113,0,7,201
21151,D113,2,67,79,1,10,159
21153,A101,1,49,55,0,1,106
21153,A102,0,32,44,0,2,78
21153,A103,2,28,25,0,2,57
21153,A104,0,64,72,0,5,141
21153,B101,1,69,46,0,9,125
21153,B102,4,69,36,0,5,114
21153,B103,0,21,12,2,2,37
21153,B104,0,13,33,0,0,46
21153,B105,0,15,15,0,1,31
21153,C101,4,53,31,2,4,94
21153,C102,2,61,22,0,2,87
21153,C103,0,23,25,0,0,48
21153,C104,1,61,32,0,2,96
21153,C105,2,37,30,0,2,71
21155,A101,2,45,39,0,13,99
21155,A102,2,54,40,1,4,101
21155,A103,2,49,48,0,7,106
21155,A104,0,34,54,1,5,94
21155,C102,1,89,148,1,6,245
21155,C103,1,47,46,0,8,102
21155,C105,0,31,18,0,1,50
21155,D102,1,97,97,0,11,206
21155,D103,3,68,69,1,5,146
21155,D104,2,26,51,1,3,83
21155,E101,4,39,52,0,12,107
21155,E102,2,83,81,1,15,182
21155,E103,0,110,106,1,8,225
21155,H101,2,78,96,1,7,184
21155,H102,3,51,49,1,5,109
21155,H103,3,26,54,0,7,90
21155,H104,1,30,51,0,4,86
21157,A101,5,94,93,3,30,225
21157,A102,6,113,89,1,18,227
21157,A103,8,104,106,1,25,244
21157,A104,8,84,39,0,25,156
21157,A105,3,83,52,0,12,150
21157,A106,1,58,33,0,12,104
21157,A107,3,162,96,2,32,295
21157,A108,3,95,48,0,20,166
21157,B101,2,80,58,1,21,162
21157,B102,9,125,71,3,31,239
21157,B103,3,43,48,2,22,118
21157,B104,6,57,49,0,13,125
21157,B105,6,106,32,1,24,169
21157,B106,4,83,68,1,23,179
21157,B107,3,103,67,1,19,193
21157,B108,1,66,44,0,12,123
21157,B109,6,59,51,0,21,137
21157,C101,8,123,68,2,36,237
21157,C102,2,66,48,0,14,130
21157,C103,6,110,73,0,22,211
21157,C104,5,158,95,1,27,286
21157,C105,3,106,94,3,17,223
21157,C106,3,53,39,2,6,103
21157,C107,3,44,24,0,11,82
21157,C108,2,103,57,3,16,181
21159,A101,1,20,13,1,1,36
21159,A102,0,12,1,0,0,13
21159,A103,2,9,3,0,2,16
21159,B101,0,8,1,0,1,10
21159,B102,0,13,8,0,4,25
21159,B103,0,16,5,0,1,22
21159,C101,2,34,19,3,1,59
21159,C102,2,15,9,0,1,27
21159,D101,0,8,8,1,1,18
21159,D102,0,5,7,0,3,15
21159,D103,2,2,1,0,2,7
21159,D104,0,2,0,0,0,2
21159,E101,3,11,7,0,0,21
21159,E102,0,30,12,0,4,46
21161,A101,2,38,41,0,3,84
21161,A102,1,5,34,0,0,40
21161,A103,0,58,86,0,15,159
21161,A104,3,38,43,0,3,87
21161,A105,3,37,34,0,6,80
21161,B102,1,15,18,0,3,37
21161,B103,1,25,11,0,5,42
21161,B104,2,34,27,0,6,69
21161,B105,1,14,8,0,3,26
21161,B106,1,65,51,1,8,126
21161,B107,3,77,57,0,10,147
21161,B108,2,106,86,1,11,206
21161,C102,2,85,90,2,23,202
21161,C103,1,54,38,0,5,98
21161,C104,0,23,40,0,5,68
21161,C105,2,85,25,0,8,120
21145,A102,2,66,87,0,4,159
21145,A104,1,24,81,1,7,114
21145,A106,3,30,31,0,2,66
21145,A110,0,71,56,0,11,138
21145,A112,2,93,66,1,18,180
21145,A113,3,131,95,0,22,251
21145,A114,2,78,48,2,4,134
21145,A115,0,50,44,0,4,98
21145,A116,3,94,99,2,9,207
21145,A117,2,4,6,0,0,12
21145,A118,3,114,42,1,21,181
21145,A119,0,24,55,1,2,82
21145,A120,1,68,38,1,8,116
21145,A121,0,32,32,0,5,69
21145,A122,1,104,99,0,24,228
21145,A124,5,59,42,1,15,122
21145,A133A,1,43,64,0,4,112
21145,B103,2,86,69,0,8,165
21145,B113,0,85,97,0,7,189
21145,B114,1,41,52,0,8,102
21145,B116,3,63,58,1,5,130
21145,B117,2,52,64,0,14,132
21145,B118,1,49,55,0,6,111
21145,B119,2,46,20,1,9,78
21145,B120,0,70,45,0,11,126
21145,B121,3,58,38,0,16,115
21145,B122,0,39,32,0,8,79
21145,B123,7,68,62,0,20,157
21145,B124,3,63,38,1,13,118
21145,B125,2,92,55,2,13,164
21145,B126,2,45,34,1,15,97
21145,B127,2,70,41,1,8,122
21145,B129,1,7,4,1,1,14
21145,B131,2,73,100,0,15,190
21145,B132,3,63,54,0,17,137
21145,B134,0,70,50,0,8,128
21145,B135,2,42,42,2,9,97
21145,C102,0,44,155,1,5,205
21145,C106,0,27,23,0,4,54
21145,C107,2,92,64,0,13,171
21145,C108,3,87,85,1,14,190
21145,C109,4,84,110,1,21,220
21145,C110,1,98,86,0,12,197
21145,C112,6,115,69,0,18,208
21145,C113,5,94,74,0,17,190
21145,C114,1,51,28,3,11,94
21145,C115,2,42,24,0,8,76
21145,C119,0,50,59,0,9,118
21145,C120,3,63,84,0,5,155
21145,C121,1,77,65,0,11,154
21145,C122,1,62,52,0,17,132
21145,C123,6,99,93,0,22,220
21145,C125,2,60,98,1,6,167
21145,C128,2,59,48,2,10,121
21147,A101,2,28,17,0,1,48
21147,A102,0,22,12,0,0,34
21147,A104,2,5,8,0,0,15
21147,A105,0,2,2,0,0,4
21147,B101,3,28,28,1,4,64
21147,B102,0,12,5,0,3,20
21147,B104,1,2,2,0,2,7
21147,D101,0,29,22,0,3,54
21147,D103,0,8,5,0,2,15
21147,D104,0,8,12,0,1,21
21147,D105,0,13,1,0,0,14
21147,D106,0,6,6,0,0,12
21147,F103,0,6,7,0,0,13
21147,F104,0,16,19,1,1,37
21147,F105,0,9,4,0,1,14
21147,F106,0,1,2,0,1,4
21147,F108,0,1,4,0,0,5
21147,F109,0,1,1,0,0,
21149,A101,1,60,30,0,4,95
21149,A102,5,109,62,1,25,202
21149,B101,1,63,69,3,10,146
21149,B102,5,52,64,1,6,128
21149,C101,5,61,52,2,11,131
21149,C102,6,73,44,1,9,133
21149,D101,7,87,63,1,17,175
21149,D102,4,102,64,2,19,191
21163,A101,2,47,57,0,6,112
21163,A102,1,37,29,1,2,70
21163,B101,3,114,95,1,10,223
21163,B102,5,103,95,1,9,213
21163,B103,0,51,32,0,7,90
21163,C101,3,80,82,5,20,190
21163,C102,3,42,48,2,12,107
21163,C103,2,52,38,2,6,100
21163,D101,4,121,122,0,14,261
21163,D102,10,139,102,0,12,263
21163,D103,2,101,61,2,13,179
21163,E101,8,102,67,2,11,190
21163,E102,3,82,78,1,15,179
21163,E103,1,59,52,1,3,116
21163,F101,2,73,79,1,14,169
21163,F102,0,62,40,1,6,109
21163,F103,1,86,61,1,9,158
21163,F104,3,74,44,0,10,131
21163,F105,3,77,71,0,13,164
21165,A101,2,30,30,0,2,64
21165,A102,1,35,34,1,5,76
21165,B101,7,93,78,0,11,189
21165,C101,3,52,48,1,8,112
21165,D101,1,46,52,0,9,108
21165,E101,0,59,43,0,6,108
21167,A101,4,120,88,0,12,224
21167,A102,0,14,16,0,1,31
21167,A103,0,74,33,0,7,114
21167,A104,0,13,17,1,2,33
21167,C101,1,41,9,0,13,64
21167,C102,5,133,81,3,17,239
21167,C104,4,73,33,2,9,121
21167,C105,2,23,6,0,2,33
21167,D101,2,110,67,2,14,195
21167,D102,5,75,62,0,12,154
21167,D103,1,51,40,3,4,99
21167,E101,5,122,104,1,9,241
21167,E102,1,85,54,0,10,150
21167,F101,2,56,62,0,7,127
21167,F102,2,94,84,0,5,185
21167,G101,4,132,111,0,19,266
21167,G102,0,80,89,0,11,180
21169,A101,4,96,95,0,17,212
21169,A102,0,66,78,1,8,153
21169,A103,3,77,51,0,14,145
21169,A104,2,59,29,0,5,95
21169,B101,2,39,33,0,13,87
21169,B102,0,6,6,1,3,16
21169,B103,2,44,39,1,12,98
21169,B104,3,49,46,0,6,104
21169,C101,2,48,37,3,5,95
21169,C102,0,22,16,0,2,40
21169,D101,2,39,32,0,9,82
21169,D102,0,20,10,0,1,31
21171,A101,0,4,8,0,0,12
21171,A102,0,13,9,0,3,25
21171,A103,0,4,4,0,0,8
21171,B101,0,8,5,0,1,14
21171,B102,1,7,17,0,1,26
21171,C101,0,11,10,0,1,22
21171,C102,0,5,9,0,0,14
21171,C103,0,11,13,0,0,24
21171,D101,0,4,5,0,3,12
21171,D102,0,14,17,1,0,32
21171,E101,0,17,12,0,1,30
21171,E102,0,10,13,0,1,24
21173,A101,1,55,42,0,2,100
21173,A102,1,63,70,0,5,139
21173,A103,1,68,90,0,5,164
21173,A104,2,70,69,0,7,148
21173,A105,0,25,60,0,2,87
21173,A106,1,71,73,0,3,148
21173,B101,2,94,57,2,13,168
21173,B102,3,102,74,1,14,194
21173,B103,3,65,75,0,3,146
21173,B104,2,87,82,1,16,188
21173,B105,2,64,70,1,9,146
21173,B107,4,89,77,0,11,181
21173,B108,4,83,72,1,10,170
21173,C101,2,49,43,1,8,103
21173,C102,1,100,79,0,9,189
21173,C103,2,94,100,1,15,212
21173,C104,4,81,82,0,16,183
21173,C105,2,38,38,0,5,83
21177,A101,1,25,35,0,5,66
21177,A102,3,63,58,0,6,130
21177,A103,2,30,40,2,8,82
21177,A104,2,44,55,1,8,110
21177,A106,2,50,51,0,4,107
21177,A107,2,59,39,0,17,117
21177,B101,4,66,71,1,11,153
21177,B102,0,53,52,0,9,114
21177,B103,1,57,38,0,6,102
21177,B104,1,101,103,1,17,223
21177,B105,0,29,37,0,8,74
21177,C101,10,128,95,2,25,260
21177,C103,0,61,53,0,10,124
21177,C104,4,78,77,1,18,178
21177,C106,5,87,72,1,17,182
21177,D101,3,106,85,1,23,218
21177,D102,1,51,51,0,10,113
21177,D103,0,101,76,1,26,204
21177,D104,2,44,37,0,17,100
21177,E101,1,30,46,1,9,87
21177,E102,0,38,36,0,5,79
21177,E103,9,98,98,0,23,228
21177,E104,0,89,89,0,12,190
21177,E105,1,77,49,0,19,146
21177,E107,2,28,20,0,4,54
21179,A101,1,23,18,0,4,46
21179,A102,6,140,139,1,11,297
21179,A103,3,85,143,1,8,240
21179,A104,3,84,63,0,8,158
21179,A105,2,141,130,4,12,289
21179,B101,1,122,88,2,15,228
21179,B102,1,56,90,0,3,150
21179,B103,5,105,80,0,12,202
21179,B104,2,103,104,0,8,217
21179,C101,2,97,105,0,7,211
21179,C102,3,85,114,0,8,210
21179,C103,1,65,90,0,2,158
21179,C104,1,95,120,1,8,225
21179,C105,3,92,81,3,7,186
21179,D101,3,92,51,1,11,158
21179,D102,6,152,120,0,6,284
21179,D103,2,95,146,0,6,249
21179,D104,2,84,68,0,4,158
21179,D105,6,139,135,0,13,293
21179,E101,1,55,68,0,5,129
21179,E102,3,128,125,2,19,277
21179,E103,4,101,93,5,4,207
21179,E104,0,70,35,0,6,111
21179,E105,1,80,90,0,2,173
21181,A101,3,73,49,1,8,134
21181,B101,3,80,65,0,5,153
21181,C101,1,86,56,0,5,148
21181,D101,3,80,96,1,15,195
21181,E101,5,86,66,0,9,166
21183,A101,2,50,58,0,6,116
21183,A102,0,50,43,0,6,99
21183,A104,2,24,18,0,5,49
21183,A105,1,59,48,0,11,119
21183,B101,6,46,53,1,2,108
21183,B102,8,83,76,3,5,175
21183,B103,4,28,23,0,6,61
21183,C101,3,51,32,0,5,91
21183,C102,3,63,34,2,5,107
21183,C103,0,92,66,0,7,165
21183,C104,3,93,52,0,9,157
21183,D101,0,51,45,0,6,102
21183,D102,1,58,44,0,6,109
21183,D104,2,22,25,1,3,53
21183,D106,1,23,31,0,2,57
21183,E101,6,58,41,1,6,112
21183,E102,0,24,20,1,3,48
21183,E103,0,33,25,1,2,61
21183,E105,1,20,19,1,3,44
21185,A101,1,69,137,0,2,209
21185,A103,1,88,101,0,7,197
21185,A104,1,126,125,0,2,254
21185,B101,0,35,49,0,0,84
21185,B102,1,74,102,0,1,178
21185,B104,1,37,39,0,2,79
21185,B105,0,77,98,1,3,179
21185,B106,1,52,74,1,1,129
21185,C101,1,43,36,0,0,80
21185,C102,4,67,82,0,4,157
21185,C103,1,65,71,0,4,141
21185,C105,1,47,61,0,6,115
21185,C106,1,30,27,0,3,61
21185,D101,2,94,91,0,3,190
21185,D103,0,59,62,1,7,129
21185,D104,1,25,47,0,1,74
21185,D106,1,78,61,0,4,144
21185,E101,0,70,68,0,5,143
21185,E102,1,96,123,0,7,227
21185,E103,0,57,61,0,2,120
21185,E104,0,32,61,0,0,93
21185,E105,0,59,58,0,4,121
21185,E106,1,13,17,0,0,31
21185,F101,1,41,40,0,3,85
21185,F102,0,61,58,0,1,120
21185,F103,1,84,84,0,1,170
21185,F104,2,35,54,0,7,98
21185,F105,0,75,88,0,3,166
21185,F106,0,18,15,0,1,34
21185,G101,0,38,95,0,2,135
21185,G102,2,80,104,0,3,189
21185,G103,2,95,80,0,6,183
21185,G105,1,23,25,0,1,50
21185,H101,1,103,96,0,5,205
21185,H103,1,73,81,1,5,161
21185,H104,1,61,65,0,8,135
21185,H105,1,38,63,0,2,104
21185,H106,0,23,34,0,1,58
21187,A101,2,32,15,0,4,53
21187,A103,1,43,18,0,5,67
21187,A104,0,18,10,0,3,31
21187,A105,3,74,43,0,6,126
21187,B102,12,115,64,2,21,214
21187,B103,3,96,67,2,8,176
21187,C101,1,22,29,0,2,54
21187,C103,1,32,36,0,5,74
21187,C104,1,62,27,0,1,91
21187,D101,4,90,72,2,16,184
21187,D102,4,56,27,2,10,99
21187,D103,0,56,22,0,7,85
21191,A101,0,8,5,0,0,13
21191,A102,3,46,39,0,7,95
21191,A103,2,36,16,1,2,57
21191,B101,4,64,56,0,12,136
21191,B102,2,47,29,0,2,80
21191,B103,1,33,31,1,12,78
21191,C101,0,29,19,0,6,54
21191,C102,3,51,37,1,8,100
21191,C103,0,29,7,0,4,40
21191,D101,4,79,65,1,9,158
21191,D102,6,46,24,1,8,85
21191,D103,4,44,32,0,6,86
21193,A101,1,32,39,2,3,77
21193,A102,1,49,15,0,7,72
21193,A103,1,33,9,1,2,46
21193,A104,2,20,5,2,1,30
21193,A105,2,37,8,0,3,50
21193,A107,0,45,22,1,7,75
21193,A108,0,37,8,0,5,50
21193,A109,0,65,37,1,7,110
21193,A110,2,49,18,0,5,74
21193,A111,1,18,19,0,0,38
21193,A112,5,68,39,2,7,121
21193,A113,1,50,24,0,4,79
21193,A114,9,86,35,2,9,141
21193,B101,4,49,28,3,7,91
21193,B102,0,39,24,1,1,65
21193,B103,0,39,34,1,5,79
21193,B104,2,44,28,1,1,76
21193,B105,0,76,41,0,5,122
21193,B106,0,61,13,0,10,84
21193,B107,1,28,13,0,6,48
21193,B108,1,28,10,0,2,41
21193,B109,1,25,14,1,2,43
21193,B110,1,61,40,0,2,104
21193,B111,3,25,26,1,2,57
21193,B112,2,23,26,0,7,58
21193,B113,0,24,20,1,3,48
21193,C102,2,31,23,0,3,59
21193,C103,3,59,24,1,5,92
21193,C104,5,61,33,0,10,109
21193,C105,3,59,12,0,6,80
21193,C106,2,45,15,0,11,73
21193,C107,3,56,25,0,9,93
21193,C108,1,38,18,0,3,60
21193,C109,1,28,10,1,6,46
21193,C110,3,39,5,0,3,50
21193,C111,0,30,8,1,4,43
21193,C114,0,65,28,0,6,99
21199,A101,0,17,13,0,1,31
21199,A102,1,37,39,1,4,82
21199,A103,0,28,32,0,5,65
21199,A104,0,6,6,0,2,14
21199,A105,0,18,15,0,0,33
21199,A106,1,58,62,0,2,123
21199,A108,0,39,47,0,6,92
21199,A110,2,12,5,1,1,21
21199,A111,0,4,2,0,1,7
21199,A112,0,10,4,0,0,14
21199,B101,1,13,8,0,1,23
21199,B102,0,7,7,0,0,14
21199,B103,0,6,2,0,0,8
21199,B104,1,16,13,0,0,30
21199,B105,0,22,14,1,3,40
21199,B106,0,27,20,0,1,48
21199,B107,0,27,22,0,5,54
21199,B108,0,19,22,0,4,45
21199,B109,0,13,7,1,1,22
21199,B110,1,20,21,1,8,51
21199,B111,0,11,18,0,1,30
21199,B112,2,11,18,0,1,32
21199,B113,0,5,5,0,0,10
21199,C101,0,15,10,0,0,25
21199,C102,0,31,45,0,2,78
21199,C103,1,41,38,0,1,81
21199,C104,1,51,49,0,4,105
21199,C105,0,40,23,0,2,65
21199,C106,0,27,19,0,6,52
21199,C110,0,38,34,1,2,75
21199,C111,1,8,6,0,0,15
21199,C112,0,1,0,0,0,1
21199,C113,0,1,5,0,0,6
21199,D101,1,26,27,0,3,57
21199,D102,0,11,9,0,1,21
21199,D103,0,17,4,0,2,23
21199,D104,0,18,6,0,1,25
21199,D105,0,21,31,0,4,56
21199,D106,0,10,6,0,1,17
21199,D107,1,4,6,0,0,11
21199,D108,1,17,10,1,1,30
21199,D109,0,15,14,0,2,31
21199,D110,0,21,32,0,3,56
21199,D111,0,12,12,0,3,27
21199,D113,0,13,14,0,0,27
21199,D115,1,23,23,0,2,49
21199,E101,1,12,19,0,2,34
21199,E103,0,38,51,0,4,93
21199,E104,0,22,21,0,1,44
21199,E105,1,40,41,0,1,83
21199,E107,1,6,14,0,2,23
21199,E108,0,30,28,1,3,62
21199,E109,0,8,9,0,1,18
21199,E110,0,4,14,0,0,18
21199,E111,0,45,57,2,5,109
21199,E112,1,20,17,0,1,39
21203,A101,0,33,36,1,1,71
21203,A102,1,10,18,1,1,31
21203,B101,0,12,11,1,1,25
21203,B102,0,14,28,1,3,46
21203,C101,1,27,24,0,6,58
21203,C102,0,25,20,0,1,46
21203,C103,0,3,0,0,2,5
21203,D101,0,43,24,0,2,69
21203,D102,0,23,5,1,0,29
21203,D103,0,11,2,0,1,14
21203,E101,0,15,22,0,1,38
21203,E102,0,5,10,0,2,17
21203,E103,0,4,14,0,0,18
21203,E104,0,8,3,0,1,12
21203,E105,0,12,7,0,0,19
21205,A101,2,54,71,0,0,127
21205,A102,0,95,76,2,8,181
21205,A103,0,42,27,0,0,69
21205,A105,0,33,45,0,1,79
21205,A106,4,125,109,0,8,246
21205,B102,1,36,42,2,5,86
21205,B104,2,101,95,3,2,203
21205,B105,1,115,97,0,6,219
21205,B106,4,154,107,2,14,281
21205,C101,2,103,94,2,9,210
21205,C102,0,59,24,0,0,83
21205,C103,0,39,31,0,3,73
21205,C104,3,46,34,0,2,85
21205,C106,1,82,52,0,3,138
21205,D101,0,32,23,0,2,57
21205,D102,1,74,76,1,9,161
21205,D103,0,77,86,1,7,171
21205,D104,1,60,32,0,3,96
21207,A101,0,31,27,0,0,58
21207,A102,0,21,29,0,1,51
21207,A103,0,21,15,0,1,37
21207,B101,1,20,26,0,2,49
21207,B102,0,16,15,1,3,35
21207,B103,2,34,25,0,4,65
21207,C101,0,32,17,0,2,51
21207,C102,1,16,21,0,2,40
21207,C103,0,16,16,0,1,33
21207,C104,1,17,11,0,2,31
21207,D101,0,25,23,0,1,49
21207,D102,1,14,15,0,0,30
21207,D103,0,14,8,1,1,24
21207,E101,1,26,37,0,1,65
21207,E102,0,9,18,0,2,29
21207,E103,0,8,9,1,1,19
21209,A100,2,77,45,1,5,130
21209,A102,2,42,17,0,7,68
21209,A104,2,41,46,0,4,93
21209,A106,3,85,66,0,4,158
21209,A110,2,47,44,0,2,95
21209,A112,2,32,26,0,5,65
21209,A114,0,5,11,0,1,17
21209,A116,1,22,39,1,3,66
21209,B101,0,64,47,1,1,113
21209,B103,1,51,52,0,11,115
21209,B105,3,54,55,1,3,116
21209,B109,0,32,44,0,3,79
21209,B111,0,70,44,0,8,122
21209,B113,0,56,53,1,6,116
21209,C108,1,74,46,1,5,127
21209,C110,0,52,60,0,3,115
21209,C112,1,75,66,0,6,148
21209,C114,1,45,55,0,3,104
21209,C116,2,64,77,0,8,151
21209,C118,0,70,54,0,5,129
21209,D111,1,67,66,0,2,136
21209,D113,0,69,57,0,9,135
21209,D115,3,58,68,0,2,131
21209,D119,1,46,43,0,2,92
21209,D121,0,48,50,0,5,103
21209,D123,1,65,56,0,6,128
21209,E118,0,24,30,0,5,59
21209,E120,0,29,37,0,1,67
21209,E122,0,38,100,0,1,139
21209,E124,2,34,53,0,3,92
21209,E126,1,43,38,0,0,82
21209,E128,0,26,44,0,2,72
21209,F117,2,49,106,0,10,167
21209,F119,1,51,29,1,7,89
21209,F121,0,84,76,0,6,166
21209,F123,1,54,80,0,5,140
21209,F125,0,35,25,0,0,60
21209,F127,0,48,76,0,8,132
21209,F129,0,54,54,0,7,115
21209,F131,0,55,54,1,5,115
21209,G128,1,38,59,0,1,99
21209,G130,1,43,72,0,5,121
21209,G132,3,81,61,0,4,149
21209,G134,1,46,52,1,1,101
21209,G136,1,77,63,0,5,146
21209,G138,0,0,0,0,0,0
21211,A101,0,50,58,0,10,118
21211,A102,0,47,68,0,7,122
21211,A103,0,39,54,0,7,100
21211,A104,2,47,38,0,7,94
21211,A105,5,37,64,0,1,107
21211,B101,4,88,58,2,8,160
21211,B102,8,110,64,1,21,204
21211,B103,2,40,30,0,2,74
21211,B104,4,96,124,0,9,233
21211,B105,0,51,61,2,5,119
21211,C101,5,85,98,1,15,204
21211,C102,3,119,63,2,15,202
21211,C103,2,66,71,1,12,152
21211,C104,8,90,74,0,7,179
21211,C105,0,49,40,0,5,94
21211,D101,5,66,46,0,18,135
21211,D102,3,84,60,0,17,164
21211,D103,5,43,72,0,7,127
21211,D104,5,47,47,0,14,113
21211,D105,2,49,50,0,3,104
21211,E101,3,94,112,1,10,220
21211,E102,1,53,68,0,6,128
21211,E103,0,59,93,0,10,162
21211,E104,1,34,33,0,3,71
21211,E105,0,9,9,0,1,19
21211,F101,2,45,66,0,1,114
21211,F102,2,73,79,0,7,161
21211,F103,0,27,42,0,5,74
21211,F104,1,30,27,0,1,59
21211,F105,0,27,42,0,3,72
21211,G101,0,60,89,1,9,159
21211,G102,1,53,72,0,4,130
21211,G103,0,75,92,1,6,174
21211,G104,0,48,77,1,2,128
21213,A101,3,73,56,0,15,147
21213,A102,2,46,49,1,11,109
21213,A103,2,54,45,0,4,105
21213,B101,2,49,42,0,7,100
21213,B102,1,32,41,0,2,76
21213,B103,3,97,80,1,11,192
21213,C101,0,38,37,0,6,81
21213,C103,1,36,46,1,5,89
21213,C104,5,98,93,0,15,211
21213,D101,2,19,13,0,5,39
21213,D102,2,36,38,1,8,85
21213,D103,0,44,104,1,6,155
21213,D104,3,56,47,1,6,113
21215,A101,6,123,138,1,10,278
21215,B101,2,87,60,1,9,159
21215,B102,0,56,54,1,5,116
21215,C101,2,77,63,0,6,148
21215,C102,1,96,80,1,3,181
21215,D101,2,31,30,0,3,66
21215,D102,1,53,36,1,4,95
21215,D103,0,25,22,0,2,49
21215,D104,0,14,13,0,2,29
21215,D105,1,48,34,1,6,90
21215,D106,0,0,0,0,1,1
21215,E101,2,60,52,0,2,116
21215,E102,3,77,42,1,9,132
21215,E103,0,49,31,0,3,83
21217,A101,0,30,23,0,2,55
21217,A102,1,42,38,0,3,84
21217,A104,2,70,82,1,5,160
21217,B101,0,45,42,0,5,92
21217,B102,1,52,61,1,5,120
21217,B103,0,16,35,0,2,53
21217,B104,2,24,37,0,4,67
21217,C101,0,5,9,0,1,15
21217,C103,1,10,3,0,0,14
21217,C104,2,47,78,0,4,131
21217,C105,1,64,63,1,9,138
21217,D101,0,12,4,0,0,16
21217,D102,3,62,63,3,6,137
21217,D104,2,53,55,0,2,112
21217,E101,1,59,72,0,2,134
21217,E102,0,31,44,0,0,75
21217,E103,0,33,31,1,4,69
21217,F101,0,54,25,0,3,82
21217,F102,0,71,74,0,5,150
21217,F103,0,48,81,0,3,132
21219,A101,1,47,15,0,7,70
21219,A102,2,23,21,1,9,56
21219,A103,0,26,12,0,3,41
21219,B101,4,46,15,1,6,72
21219,B102,0,46,9,0,2,57
21219,B103,0,21,5,0,0,26
21219,B104,0,12,1,0,2,15
21219,C101,1,61,77,0,10,149
21219,C102,1,52,33,0,9,95
21219,D101,0,6,14,0,2,22
21219,D102,6,102,74,0,21,203
21219,E101,0,23,18,0,7,48
21219,E102,1,32,28,0,3,64
21221,A101,8,74,95,1,11,189
21221,A102,0,6,5,0,0,11
21221,B101,3,54,26,0,10,93
21221,B102,1,56,62,1,10,130
21221,C101,2,93,98,1,19,213
21221,D101,1,59,63,4,15,142
21221,D102,0,4,0,0,3,7
21221,D103,1,19,15,0,3,38
21221,E101,3,46,33,0,13,95
21221,E102,0,29,18,1,3,51
21221,E104,1,24,20,0,1,46
21221,F101,0,24,23,1,4,52
21221,F102,3,104,48,2,11,168
21221,G101,1,51,42,0,4,98
21221,G102,2,47,27,0,4,80
21223,A101,4,47,43,0,11,105
21223,A102,3,49,16,0,11,79
21223,A103,2,59,42,0,15,118
21223,B101,0,34,38,0,3,75
21223,B103,1,46,42,0,2,91
21223,B104,0,34,45,1,8,88
21223,C101,2,38,34,0,3,77
21223,C103,3,39,39,3,12,96
21223,C104,0,71,40,1,10,122
21223,D101,1,37,14,0,3,55
21223,D102,2,32,18,1,5,58
21223,D103,1,49,33,1,9,93
21225,A101,6,100,52,3,40,201
21225,A103,1,50,51,0,31,133
21225,A104,5,45,31,0,24,105
21225,B101,4,73,44,2,25,148
21225,B102,0,68,50,0,28,146
21225,B103,3,48,42,1,17,111
21225,C101,4,98,35,1,26,164
21225,C102,4,61,24,2,13,104
21225,C103,4,53,32,0,22,111
21225,C104,2,48,8,1,11,70
21225,E102,1,69,42,0,25,137
21225,E103,4,77,29,2,15,127
21225,E104,4,72,26,0,21,123
21225,F101,6,112,71,3,41,233
21225,F102,5,29,28,0,7,69
21225,F103,4,74,76,1,28,183
21227,A101,1,42,42,0,1,86
21227,A102,1,93,93,2,5,194
21227,A103,1,51,56,1,4,113
21227,A104,0,75,68,1,9,153
21227,A105,0,80,95,1,6,182
21227,A106,1,59,53,0,5,118
21227,A107,0,37,51,0,5,93
21227,A108,3,109,93,0,2,207
21227,A109,0,111,55,0,1,167
21227,A110,2,69,134,0,8,213
21227,A111,1,30,33,1,2,67
21227,A112,0,60,54,0,4,118
21227,A113,1,43,39,1,3,87
21227,A114,0,35,48,0,3,86
21227,A115,1,39,36,1,5,82
21227,A116,0,0,0,0,0,0
21227,A117,0,0,1,0,0,1
21227,A118,0,0,0,0,0,0
21227,B101,0,111,53,0,2,166
21227,B102,0,26,28,0,1,55
21227,B103,0,42,25,0,2,69
21227,B104,1,32,82,0,2,117
21227,B105,1,31,85,0,1,118
21227,B106,0,49,67,0,1,117
21227,B107,0,54,46,0,1,101
21227,B108,1,34,32,0,0,67
21227,B109,0,80,55,0,4,139
21227,B110,0,182,75,0,2,259
21227,B111,1,44,34,0,1,80
21227,B112,0,7,2,0,0,9
21227,B113,0,12,9,0,3,24
21227,C101,2,74,58,1,8,143
21227,C102,2,116,84,0,2,204
21227,C103,1,104,52,0,5,162
21227,C104,0,120,98,0,4,222
21227,C105,3,80,72,0,7,162
21227,C106,0,37,13,0,2,52
21227,C107,1,95,100,0,13,209
21227,C108,1,23,26,1,2,53
21227,C109,0,0,0,0,0,0
21227,C110,0,61,32,0,4,97
21227,C111,1,68,69,0,5,143
21227,C112,1,108,114,2,5,230
21227,D101,2,113,132,0,19,266
21227,D102,1,106,67,0,2,176
21227,D103,3,29,37,1,5,75
21227,D104,2,42,69,0,6,119
21227,D105,2,78,67,0,5,152
21227,D106,1,51,45,1,5,103
21227,D107,2,22,22,0,3,49
21227,D108,1,45,59,0,9,114
21227,D109,3,69,79,0,6,157
21227,D110,0,46,48,0,2,96
21227,D111,0,48,44,3,2,97
21227,D112,6,109,114,0,6,235
21227,D113,1,65,49,0,2,117
21227,D114,0,61,42,0,4,107
21227,D116,0,2,0,0,0,2
21227,E101,2,72,97,1,3,175
21227,E102,5,132,62,0,9,208
21227,E103,2,45,35,0,6,88
21227,E104,2,39,27,0,4,72
21227,E105,2,46,40,0,8,96
21227,E106,4,103,70,3,9,189
21227,E107,3,110,71,1,5,190
21227,E108,1,69,55,0,13,138
21227,E109,1,59,64,0,5,129
21227,E110,1,92,102,1,4,200
21227,E111,0,53,57,0,2,112
21227,E112,2,53,40,0,1,96
21227,F101,4,59,55,0,17,135
21227,F102,5,87,63,1,12,168
21227,F103,5,71,43,1,8,128
21227,F104,0,107,97,0,15,219
21227,F105,1,72,62,0,6,141
21227,F106,3,81,45,0,9,138
21227,F107,2,47,58,0,9,116
21227,F108,4,77,88,0,12,181
21227,F109,0,36,28,2,2,68
21227,F110,1,50,32,0,8,91
21227,F111,0,27,23,0,2,52
21227,F112,1,23,16,0,4,44
21227,F113,2,70,74,0,9,155
21227,F114,0,46,58,0,2,106
21227,F115,0,40,25,0,0,65
21227,F116,0,0,0,0,0,0
21227,F117,0,10,5,0,0,15
21227,F118,2,46,54,0,9,111
21229,A101,0,25,35,1,2,63
21229,A102,0,35,12,0,3,50
21229,A103,0,9,12,0,2,23
21229,B101,3,25,20,0,4,52
21229,B102,1,63,46,0,7,117
21229,C101,0,26,14,0,9,49
21229,C102,0,40,25,2,6,73
21229,C103,0,30,22,1,5,58
21229,D101,1,37,57,0,4,99
21229,D102,2,36,68,0,2,108
21229,E101,1,28,39,0,2,70
21229,E102,2,76,87,2,6,173
21229,F101,1,60,38,1,10,110
21229,F102,2,74,91,1,9,177
21231,A101,0,6,24,0,2,32
21231,A102,0,9,21,0,0,30
21231,A103,0,18,33,0,1,52
21231,A106,1,5,31,0,1,38
21231,A107,0,15,19,0,0,34
21231,B101,0,28,35,2,4,69
21231,B102,0,17,13,0,1,31
21231,B103,0,28,12,1,1,42
21231,B106,0,16,5,1,1,23
21231,B109,1,11,12,0,3,27
21231,D104,1,17,21,0,0,39
21231,D105,0,9,19,0,0,28
21231,D106,1,17,25,2,1,46
21231,D107,0,5,14,1,0,20
21231,D110,1,21,41,0,1,64
21231,G101,2,47,57,0,1,107
21231,G103,0,6,16,0,1,23
21231,G104,2,38,31,0,2,73
21231,G106,1,28,48,0,2,79
21233,A101,9,136,63,2,58,268
21233,A102,3,74,28,2,36,143
21233,A103,5,107,41,1,66,220
21233,A104,5,68,17,3,39,132
21233,A105,4,43,26,2,21,96
21233,B101,3,53,31,0,18,105
21233,B102,6,106,61,1,43,217
21233,B103,6,80,43,1,21,151
21233,B104,3,61,31,0,19,114
21233,B105,9,82,60,1,41,193
21233,C101,6,104,109,0,29,248
21233,C102,0,66,32,1,19,118
21233,C103,0,77,67,2,23,169
21233,C104,3,83,45,0,23,154
21235,A101,0,6,1,0,0,7
21235,A103,0,17,10,0,4,31
21235,A104,0,6,11,0,1,18
21235,A105,0,4,1,0,2,7
21235,A106,0,11,23,0,1,35
21235,A107,1,12,14,0,1,28
21235,A109,0,16,26,0,2,44
21235,A111,0,7,6,0,0,13
21235,B101,0,29,52,0,2,83
21235,B102,0,8,4,0,0,12
21235,B104,0,7,11,0,1,19
21235,B105,0,26,28,0,1,55
21235,B106,3,31,30,0,3,67
21235,B107,0,20,32,0,3,55
21235,B108,0,5,10,1,0,16
21235,B109,0,5,12,0,1,18
21235,B110,0,23,30,0,3,56
21235,C101,0,1,2,0,0,3
21235,C102,1,2,5,0,1,9
21235,C103,0,0,1,0,1,2
21235,C104,3,4,11,1,0,19
21235,C105,0,2,4,0,1,7
21235,C106,0,3,4,0,1,8
21235,C107,0,8,10,0,1,19
21235,C108,1,5,4,0,0,10
21235,C109,0,6,14,0,0,20
21235,C110,0,2,5,0,0,7
21235,C111,0,11,8,0,1,20
21235,C112,0,4,3,0,3,10
21235,C113,0,3,5,0,0,8
21235,C114,0,7,2,0,1,10
21235,D101,0,12,13,0,1,26
21235,D102,1,20,27,0,3,51
21235,D104,0,26,27,0,3,56
21235,D105,0,15,13,0,2,30
21235,D106,1,22,35,1,1,60
21239,A101,2,92,76,1,11,182
21239,A102,3,172,164,0,13,352
21239,B101,3,98,65,0,11,177
21239,B102,2,62,45,0,5,114
21239,B103,1,54,63,0,1,119
21239,C101,2,106,116,0,9,233
21239,C102,8,121,91,0,10,230
21239,D101,1,110,113,0,9,233
21239,D102,1,103,112,0,11,227
21239,E101,3,97,110,2,9,221
21239,E102,0,94,116,0,8,218
21239,F101,0,117,89,1,9,216
21239,F102,3,117,123,0,19,262
21239,G101,3,120,136,0,11,270
21239,G102,5,79,84,1,3,172
21239,G103,2,75,79,0,6,162
21239,H101,0,69,60,1,7,137
21239,H102,2,89,85,3,6,185
21239,H103,1,99,83,1,13,197
